ကမေ	က
ဂတိ	ကတိ
ကနဉီး	ကနဦး
ကနည်း	ကနေ
ကနေ ့	ကနေ့
ရက	က
ကလဝိကင််	ကလဝိကင်
ကလိဂင််	ကလိဂင်
ကလိဂင််ရ	ကလိဂင်ရ
ခရေး	ကလေး
ခလေး	ကလေး
ခလေး	ကလေး
ခရေးတွေ	ကလေးတွေ
ကလေးသူကယ်	ကလေးသူငယ်
ကလော်ထုတ်ခြင်တော့တာပါဘဲ	ကလော်ထုတ်ချင်တော့တာပါဘဲ
ကလကင််	ကလင်ကလင်
ကလဲ	ကလည်း
ကဠိဂင််ရ	ကဠိဂင်ရ
ကာကွယ်နိ်ုင်အောင်	ကာကွယ်နိုင်အောင်
ကာရကံရှင်	ကာယကံရှင်
ကါရဂ ံရှင်	ကာယကံရှင်
ကာရဝေလ႞	ကာရဝေလ
ကလ	ကာလ
ကာဠသုတၩ	ကာဠသုတ
ကါး	ကား
ကားကျပ်တာရယ်	ကားကြပ်တာရယ်
ကားမောင်သမား	ကားမောင်းသမား
ကိလဥ်ဇ	ကိလဉ်ဇ
ကုရုဂင််	ကုရုဂင်
ကူညီး	ကူညီ
ကုူညီစောင့်ရှောက်ရမှာပေါ့	ကူညီစောင့်ရှောက်ရမှာပေါ့
ကူးသွားပါတယျ	ကူးသွားပါတယ်
ကဲ့သလို၊	ကဲ့သို့၊
ကဲ့သိ်ု့ 	ကဲ့သို့
ကောမက်	ကောမန့်
ကော်မီတိ	ကော်မတီ
ကော်မီတီ	ကော်မတီ
ကိူ	ကို
ကိိုု	ကို
ကို	ကို
ကိုကိုဂြာီး	ကိုကိုကြီး
ကိုး	ကို
ကိုဘဲ	ကိုပဲ
ကိုကော	ကိုရော
ကိုလံဘီယား	ကိုလံဘီယာ
ကိုလဲ	ကိုလည်း
ကိုယ်သိဒယ်	ကိုသိတယ်
ကိုးကန် ့	ကိုးကန့်
ကိုးကန် ့ 	ကိုးကန့်
ကိုးကန် ့ နဲ ့ 	ကိုးကန့်နဲ့ 
ကိုးကယ်	ကိုးကွယ်
က်ု	ကို
က်ုိ	ကို
ကောက်ကိုင်လိ်ုက်မိသည်	ကောက်ကိုင်လိုက်မိသည်
ကင်းလွခွင့်	ကင်းလွတ်ခွင့်
ကောင်းကောငး်	ကောင်းကောင်း
ကောင်းကျပါတယ်	ကောင်းကြပါတယ်
ကောင်းပဗျာ	ကောင်းပါ့ဗျာ
ကိုင်တယ်ဖြေရှင်းပေးဖို့	ကိုင်တွယ်ဖြေရှင်းပေးဖို့
ဂဏဍ္ဍ	ကဏ္ဏ
ကပ်ပြား	ကဒ်ပြား
ကန်းတော့ပါသည်	ကန်တော့ပါသည်
ကတော့ပွဲ	ကန်တော့ပွဲ
ကန့််သတ်မှတ်ချက်	ကန့်သတ်ချက်
ကုန်ကျမ်း	ကုန်ကြမ်း
ကုန်ဆုူံစေပါတယ်	ကုန်ဆုံးစေပါတယ်
ကုန်ဆုံးပြိး	ကုန်ဆုံးပြီး
ကုန် ပစ္စည် း	ကုန် ပစ္စည်း
ကုတ်သွယ်ရေး	ကုန်သွယ်ရေး
ကပ်နေပါဘီနော်	ကပ်နေပါပြီနော်
ကတ်မှီသွားနဲ့	ကပ်မှီသွားနဲ့
ကမ္ဘာ့ကျော်	ကမ္ဘာကျော်
ကမ္ဘ္ဒာမှာ	ကမ္ဘာမှာ
ကမ်းလျားျမှု	ကမ်းလှမ်းမှု
ကမ် းလှမ် းမှု	ကမ်းလှမ်းမှု
ကမ် းလှမ် းလိုက် သည်	ကမ်းလှမ်းလိုက် သည်
ကယ်တိုင်နိုင်ခဲ့ပါတယ်	ကယ်တင်နိုင်ခဲ့ပါတယ်
ကိ်ုယ် 	ကိုယ် 
ကို်ယ်	ကိုယ်
ကိုယ်ကျိူး	ကိုယ်ကျိုး
ကိုယ်ကြိုး	ကိုယ်ကျိုး
ကိုယ်ခြင်းစာ	ကိုယ်ချင်းစာ
ကိုယ်ချင်းစာကြည့်စေချင်တယ််	ကိုယ်ချင်းစာကြည့်စေချင်တယ်
ကိယ် ချင်းမစာ	ကိုယ်ချင်းမစာ
ကိုစား	ကိုယ်စား
ကိုယ်စားလည်	ကိုယ်စားလှယ်
ကိုယ်စီကိုယ်ဌ	ကိုယ်စီကိုယ်ငှ
ကိ်ုယ်စီနဲ့	ကိုယ်စီနဲ့
ကိုယ့်တိုင်ကစပြီး	ကိုယ်တိုင်ကစပြီး
ကိုယ်တိ်ုင်ကိုယ်ကျ	ကိုယ်တိုင်ကိုယ်ကျ
ကိုယ်တိုင်ဘဲ	ကိုယ်တိုင်ပဲ
ကိ်ုယ်တိုင်လည်း	ကိုယ်တိုင်လည်း
ကိုယ် ပို်ုင် 	ကိုယ် ပိုင် 
ကိုယ်လုံုးတီး	ကိုယ်လုံးတီး
ကိိုယ်ဟာ 	ကိုယ်ဟာ 
ကိုယ်အလေးချိ်န်	ကိုယ်အလေးချိန်
ကိ်ုယ့်	ကိုယ့်
ကို်ုယ့်	ကိုယ့်
ကိုယ်	ကိုယ့်
ကိ်ုယ်ကိုယ့်ကို	ကိုယ့်ကိုယ်ကို
ကိုယ့်ကိုယ်ကိုယ်လညး်	ကိုယ့်ကိုယ်ကိုယ်လည်း
ကိုယ် ့	ကိုယ့်
ကိုယ့််	ကိုယ့်
ကိုဂိုးကိုယ်ဘဲသွင်းမှာပေါ့လိ်ု့	ကိုယ့်ဂိုးကိုယ်ပဲသွင်းမှာပေါ့လို့
ကို့နိုင်ငံထုတ်ပစ္စည်းကို 	ကိုယ့်နိုင်ငံထုတ်ပစ္စည်းကို 
ကို့ပြည်တငွ်းဖြစ်ကို	ကိုယ့်ပြည်တွင်းဖြစ်ကို
ကိုယ် ့မှာ ရှိသည် ့ 	ကိုယ့်မှာ ရှိသည့်
ကွာ့ကို	ကိုယ့်ဟာကို
ကိ်ုယ့်ဟာကိ်ုယ်တော့	ကိုယ့်ဟာကိုယ်တော့
ကွကိုယ်တော့	ကိုယ့်ဟာကိုယ်တော့
ကိုယ့်အသိစိတ်နဲ့ကိုုယ်	ကိုယ့်အသိစိတ်နဲ့ကိုယ်
ကြေနပ်တာမဟုတ်ဘူး	ကျေနပ်တာမဟုတ်ဘူး
ေ ကျနပ်ေ နမိပါပီ	ကျေနပ်နေမိပါပြီ
ကြေနပ်နိုင်မှု	ကျေနပ်နိုင်မှု
ကျေးပွန်းစွား	ကျေပွန်စွာ
ကျေးကျွှန်	ကျေးကျွန်
ကျေးငှက်တေအွတကွ်	ကျေးငှက်တွေအတွက်
ကျေးဂျူးတင်ပါတယ်	ကျေးဇူးတင်ပါတယ်
ေ ကျးဇူးပါ	ကျေးဇူးပါ
ကျေးဇူးပြုရျ်	ကျေးဇူးပြု၍
ကျေးရွာကိ်ု	ကျေးရွာကို
ကျေး၇ွာ	ကျေးရွာ
ကျော်လွှာ	ကျော်လွှား
ကြက်သရေ	ကျက်သရေ
ကျောက်တငွ်းကြီး	ကျောက်တွင်းကြီး
ကျောက်ပနナု 	ကျောက်ပနု
ဆကျာင်းကလုပ်ပေးာ လေး	ကျောင်းကလုပ်ပေးတာလေး
ကျော်း	ကျောင်း
ကျောင် း	ကျောင်း
 ေကျာင်းတက် 	ကျောင်းတက် 
ကျောင် းတွင် းသို့	ကျောင်းတွင်းသို့
ကျောင်းပို ့	ကျောင်းပိုးအိတ်
ကျောင်းရောက်နေပါပီဏော်	ကျောင်းရောက်နေပါပီနော်
ကျောင် းသား	ကျောင်းသား
ကျောင်းသားတွေဘဲ	ကျောင်းသားတွေပဲ
ကျောင်းသားနဲ့ဘဲ	ကျောင်းသားနဲ့ပဲ
ကျောင်းသွားနေကျ	ကျောင်းသွားနေကြ
ကျောင်အုပ်	ကျောင်းအုပ်
ေကျာင်	ကျောင်း
ကျန် သည် ့ 	ကျန် သည့်
ကျမ်းမာရေး	ကျန်းမာရေး
ကျန်းမာရေးဘတ်	ကျန်းမာရေးဘက်
ကျုပ်တို ့က	ကျုပ်တို့က
ကျုပ်တို ့	ကျုပ်တို့
ကျယ်ကျယ့်ပြန်	ကျယ်ကျယ်ပြန့်ပြန့်
ကျနော်တို့	ကျွန်တော်တို့
ကြတော	ကြတော့
ကြပါတယါ်	ကြပါတယ်။
ကြပါလိုစ်	ကြပါလို့
ကြပီ	ကြပြီ
ကြျသွားခဲ့ပါတယ်	ကြသွားခဲ့ပါတယ်
ကြာတော့မှာ	ကြာတော့မှ
ကြာပီ	ကြာပြီ
ကြားခဲ့၇တော့တာပါပဲ	ကြားခဲ့ရတော့တာပါပဲ
ကြားဘူးတယ်	ကြားဖူးတယ်
	ကြားဖြတ်ရွေးကောက်ပွဲ
ဂျီး	ကြီး
ကြီးဆိုးလာနိုင်တယ်	ကြီးစိုးလာနိုင်တယ်
ကြိးတာ	ကြီးတာ
ကြီးပြင်းခဲရ	ကြီးပြင်းခဲ့ရ
ကြီးပြင်းခဲ့၇တဲ့	ကြီးပြင်းခဲ့ရတဲ့
ကြိးပြင်းခဲ့၇တယ်	ကြီးပြင်းခဲ့ရတယ်
ကျေညာကတဲက	ကြေညာကတည်းက
ကျေညာ	ကြေညာ
ကျေညာချက်	ကြေညာချက်
ကြော် ညာ	ကြော်ငြာ
ကြော် ညာခ	ကြော်ငြာခ
ကြောညာတွေ	ကြော်ငြာတွေ
ကြော် ညာပေးခြင် း	ကြော် ညာပေးခြင်း
ကြော် ညာပေးရင် း 	ကြော် ညာပေးရင်း 
ကြိုတင်ပြင်ဆင်ချျိန်	ကြိုတင်ပြင်ဆင်ချိန်
ကျိူ	ကြိုးစား
ကျိုးစား 	ကြိုးစား 
ကျိုူ	ကြိုးစား
ုကြိုးစားစရာတွေကို	ကြိုးစားစရာတွေကို
ကျိုးစားပြီး	ကြိုးစားပြီး
ကြိုးစာရှာရ	ကြိုးစားရှာရ
ကျိုးပမ်း	ကြိုးပမ်း
ကြိုးပမ်းမှေု	ကြိုးပမ်းမှု
ကျိုးပမ်းမှုတွေ	ကြိုးပမ်းမှုတွေ
ကြောက်ရွှံခြင်း	ကြောက်ရွှံ့ခြင်း
ကြုိက် လဲ 	ကြိုက် လဲ
ုကြည့်ကောင်းတာကျမတူတော့ဘူး	ကြည့်ကောင်းတာကျမတူတော့ဘူး
ကြည့်ု	ကြည့်
ကြည့်ဒဲ့သူ	ကြည့်တဲ့သူ
ကြည့်တတ်ဘို 	ကြည့်တတ်ဖို့
ကြည့်နေမယ့်	ကြည့်နေမယ့်
ကျိနေရင်း	ကြည့်နေရင်း
ကြည်ပါမယ်	ကြည့်ပါမယ်
ကြည့်ပါဦးဓ	ကြည့်ပါဦး
ကြည့်ပီး	ကြည့်ပြီး
ကြည့်ပြိး	ကြည့်ပြီး
ကြည့်ပြေားစေချင်တယ်	ကြည့်ပြောစေချင်တယ်
ကြည့်ရှှုု	ကြည့်ရှု
ကြည့်ရှု ့ရန် 	ကြည့်ရှုရန် 
ကြည့်ရှူုသူ	ကြည့်ရှူသူ
ကြည့်လိ်ုက်လို.	ကြည့်လိုက်လို့
ကြည့်လျင်	ကြည့်လျှင်
ကျန့်ကြာ	ကြန့်ကြာ
ကြုံကြိုက်တုံး	ကြုံကြိုက်တုန်း
ကြုံဘူးတယ်	ကြုံဖူးတယ်
ကြုံးသလို	ကြုံသလို
ကွာတဲ့	ကွာတယ်
ကွားမလည်း	ကွာမလည်း
ကွေ့ပတ်တ်	ကွေ့ပတ်
ကွန်ခရစ်တုံး	ကွန်ကရစ်တုံး
ကွန်ပြူတာ	ကွန်ပျူတာ
ကွန်ပူတာ	ကွန်ပြူတာ
ကွန်ပြုတာ	ကွန်ပြူတာ
ကျနော့ပါးစပ်	ကျွန်တော့်ပါးစပ်
ကနော်	ကျွန်တော်
ကျနော်	ကျွန်တော်
ကျနော် 	ကျွန်တော်
ကျနော်တို့က	ကျွန်တော်
ကျနော်ု	ကျွန်တော်
ကျော်	ကျွန်တော်
ကျန်နော်	ကျွန်တော်
ကွန်တေ	ကျွန်တော်
ကွျန်တော်	ကျွန်တော်
ကျွန်နော်	ကျွန်တော်
ကျနော်တို့ကို	ကျွန်တော်တို့ကို
ကျွန်တော်တို ့ကို	ကျွန်တော်တို့ကို
ကျနော်တ	ကျွန်တော်တို့
ကျနော်တော့	ကျွန်တော်တို့ 
ကျနော်တို	ကျွန်တော်တို့
ကျနော်တို့	ကျွန်တော်တို့ 
ကျနော်တို့ 	ကျွန်တော်တို့ 
ကျနော်တို့	ကျွန်တော်တို့
ကျန်နော်တို့	ကျွန်တော်တို့
ကျွန်တော်တိ်ု့	ကျွန်တော်တို့
ကျနော်တို့တွေ	ကျွန်တော်တို့တွေ
ကျနော်တိုမြင့်တွေတာ ့	ကျွန်တော်တို့မြင်တွေ့တာ
ကျနော်တိုမြင့်တွေတာ ့စောင့်ကြည့်တာ	ကျွန်တော်တို့ မြင်တွေ့တာ စောင့်ကြည့်တာ
ကျနော်များ	ကျွန်တော်များ
ကျနော်ရဲ့	ကျွန်တော်ရဲ့
ကျနော်ရော	ကျွန်တော်ရော
ကျနော့	ကျွန်တော့်
ကျနော့် 	ကျွန်တော့် 
ကျနော့်	ကျွန်တော့်
ကျ့န်တော့်	ကျွန်တော့်
ကျော့်	ကျွန်တော့်
ကျမ	ကျွန်မ
ကမတို့	ကျွန်မတို့
ကျမတို့	ကျွန်မတို့
ကျွန်မတို	ကျွန်မတို့
ကျွမ် းကျင် တယ်	ကျွမ်းကျင် တယ်
ကြွမ်းကျင်သူများ	ကျွမ်းကျင်သူများ
ခနခန	ခဏခဏ
ခနစောင့်	ခဏစောင့်
ခနတာ	ခဏတာ
ခနတော့	ခဏတော့
ခဏထွက်ပီး	ခဏထွက်ပြီး
ခနပါ	ခဏပါ
ခန	ခန
ခနပါ	ခနပါ
ခမျ	ခဗျာ
ခများတို ့	ခဗျားတို့
ခများတို ့	ခများတို့
ခရမ်းချည်	ခရမ်းချဉ်
ခါးချိတ်လိ်ု့	ခါးချိတ်လို့
ခုဆယ်	ခုနစ်ဆယ်
၂၀၁၄ာခုနှစ် 	၂၀၁၄ ခုနှစ် 
ခေးလည်း	ခေးလဲ
ခဲ	ခဲ့
ခေါ်နေp	ခေါ်နေပြီ
ခံနိင်မူ	ခံနိုင်မှု
ခံနိုင်မူ	ခံနိုင်မှု
ခိုလုံခဲ့ရတာ	ခိုလှုံခဲ့ရတာ
ခိုစားတာ	ခိုးစားတာ
ခက်ခဲလွမ်းပါတယ်	ခက်ခဲလွန်းပါတယ်
ခက်ညံညံ	ခက်ညံ့ညံ့
ခိုင်းမိ	ခိုက်မိ
ခင် ညွန် ့	ခင် ညွန့်
ခင်ညွန် ့	ခင်ညွန့်
ခင်ပီဆို	ခင်ပြီဆို
ခင်ဗျား။	ခင်ဗျာ။
ခင်ဗျားတို	ခင်ဗျားတို့
ခေါင် း	ခေါင်း
ခေါင်စဉ်	ခေါင်းစဉ်
ခေါင်းစဥ်	ခေါင်းစဉ်
ခေါင်းပြူကြည့်ကြအုန်	ခေါင်းပြူကြည့်ကြအုံး
ခိုင်ခံမှု	ခိုင်ခံ့မှု
ခိုင်ထူ	ခိုင်ထူး
ခိုင်မလာခဲ့	ခိုင်မလာခဲ့
ခုတ်ထည့်လိုပ်မယ်	ခုတ်ထည့်လိုက်မယ်
ခေါတ်	ခေတ်
ခေါတ်သစ်	ခေတ်သစ်
ခေါတ်ဟောင်း	ခေတ်ဟောင်း
ခန္ဓာကိ်ုယ်	ခန္ဓာကိုယ်
ခန် ့ 	ခန့်
ခမ်းမ	ခန်းမ
ချေးငွ	ချေးငွေ
ချ	ချို့တဲ့
ချို ့ယွင်းချက်	ချို့ယွင်းချက်
ချိုးဖေါက်တာ	ချိုးဖောက်တာ
ချိုးဖေါက်တာတွေ	ချိုးဖောက်တာတွေ
ချုးဖောက်မှု	ချိုးဖောက်မှု
ချိုးဖောက်မူ	ချိုးဖောက်မှု
ချိုးဖေါက်မှု	ချိုးဖောက်မှု
ချက်ကျွေူးတာ	ချက်ကျွေးတာ
ချက်ခြင်း	ချက်ချင်း
ချစ်ခွန်းချိိုသာ	ချစ်ခွန်းချိုသာ
ချစ်နိူင်	ချစ်နိုင်
ချစ်ပြား	ချစ်ပ်ပြား
ကြည့်ပဲ	ချည်းပဲ
ချည်းဘဲ	ချည်းပဲ
ချိန်မာ	ချိန်မှာ
ချုပ်ကိ်ုင်တယ်	ချုပ်ကိုင်တယ်
ခြေတောက်	ခြေထောက်
ခြေထှောက်နဲ ့	ခြေထှောက်နဲ့
ရ၇ ခြေမြန်တပ်မ	၇၇ ခြေမြန်တပ်မ
ခြိမ်းချောက်	ခြိမ်းခြောက်
ခြိမ်းချောက်မှု	ခြိမ်းခြောက်မှု
ခွေဘေးမဲ့ခြံကြီး	ခွေးဘေးမဲ့ခြံကြီး
ခွဲပေးမာလဲ	ခွဲပေးမှာလဲ
ခွင့်မလွတ်ပါနဲ့	ခွင့်မလွှတ်ပါနဲ့
ဂဏာန်း	ဂဏန်း
ကရုစိုက်	ဂရုစိုက်
ဂရုစိ်ုက်	ဂရုစိုက်
ဂရံတိီကဒ်ပါ	ဂရံတီကဒ်ပါ
ဂူအနံ့	ဂူအနှံ့
ဂုဏ်ဆောင်နိုငေ် အာ င်	ဂုဏ်ဆောင်နိုင်အောင်
ဂုဏယူချင်ရင် 	ဂုဏ်ယူချင်ရင် 
ဂုဏ်လည်ယူပါတယ်	ဂုဏ်လည်းယူပါတယ်
ဂစ်စ်	ဂတ်စ်
ဂျင်းထည့်တယ်ကောင်	ဂျင်းထည့်တဲ့ကောင်
ငလျင်�လှုပ်�တယ်�	ငလျင်လှုပ်တယ်
နာတို့ 	ငါတို့ 
င့ကို	ငါ့ကို
င့	ငါ့
ငါ	ငါ့
ငါ့စီ	ငါ့ဆီ
ငုံပြီ	ငုံပြီး
ငယ်ငယ်တုံးက	ငယ်ငယ်တုန်းက
ယေ်ယေ်တုန်းကလည်း	ငယ်ငယ်တုန်းကလည်း
ယေ်သေးတယ်လေ	ငယ်သေးတယ်လေ
ညည်းငွေ့ဖို့	ငြီးငွေ့ဖို့
ညင်းခုံ	ငြင်းခုံ
ငြိမ်တဲံ	ငြိမ်တဲ့
ငြီမ်းချမ်း	ငြိမ်းချမ်း
ငွေကြေား	ငွေကြေး
ငွေဒါဏ်	ငွေဒဏ်
ငွေရှာလာသည် ့	ငွေရှာလာသည့်
ဌား	ငှား
ဌားလာရင်	ငှားလာရင်
ဌားဝတ်လိုက်ရုံပေါ့	ငှားဝတ်လိုက်ရုံပေါ့
ဌက်	ငှက်
စကါး	စကား
စကားပြောရမည် ့ 	စကားပြောရမည့်
စကားလူံး	စကားလုံး
စန်း	စခန်း
စတဲပ	စတဲ့
စတိုခန်	စတိုခန်း
စတိတ်စဉ်	စတိတ်စင်
စံနစ်	စနစ်
စံပါးကြီး	စပါးကြီး
စပြိး	စပြီး
စဂျ်	စ၍
ကိုလုံး	စလုံး
စသည် ့	စသည့်
စါ	စာ
စာတိုကုူးကြတာဖြစ်လို့ 	စာတိုကူးကြတာဖြစ်လို့ 
စာတမ်	စာတမ်း
စာတမ်းလမ်း	စာတမ်းလည်း
စာမိက်နှာ	စာမျက်နှာ
စာရင်းမှာမှာ	စာရင်းမှာ
စာသင်မဲကိစ္စ	စာသင်မဲ့ကိစ္စ
စာသင်မဲ့	စာသင်မယ့်
စာအိပ် 	စာအိတ်
စားကြပါအူး	စားကြပါဦး
စားခဲ	စားခဲ့ပါ
စားဖို ့ 	စားဖို့
စာရိတ်	စားရိတ်
စားလိုးရသည်	စားလို့ရသည်
စီစဉ်ပေးနိူင်	စီစဉ်ပေးနိုင်
စီပွာရှာ	စီပွားရှာ
စီမန်ကိန်း	စီမံကိန်း
၂ဆီး	၂စီး
စီးနှင် းသူ 	စီးနှင်းသူ 
စိးပွားရေး	စီးပွားရေး
စီးပွါးရေး	စီးပွားရေး
စီးပွားေ၇း	စီးပွားရေး
စီးပွါးရေးဆိုင်ရာ	စီးပွားရေးဆိုင်ရာ
စေသနာ	စေတနာ
စံချိန်စံညွန်း 	စံချိန်စံညွှန်း
စံချိတင်	စံချိန်တင်
စိ့းမိုးရေး	စိုးမိုးရေး
စိုးရိမ်ကြောင့်ကျ	စိုးရိမ်ကြောင့်ကြ
စိုးရိ်မ်	စိုးရိမ်
စို၇ိမ်	စိုးရိမ်
စိူးလို့လါး	စိုးလို့လား
စက်ပြီး	စက်ဘီး
စက်မူဇုံ	စက်မှုဇုန်
စောက်ဟြေ	စောက်ပြော
စကာၤပူ	စင်္ကာပူ
စြင်္ကန်လမ်း	စင်္ကြန်လမ်း
စောင်မယ်	စောင့်မယ်
စောင့်ရှောက်နိူင်ပါစေကြောင်း	စောင့်ရှောက်နိုင်ပါစေကြောင်း
စောင် ့လိုက်	စောင့်လိုက်
စ်ုင်းမော်ခမ်း	စိုင်းမော်ခမ်း
စစ်တပက်	စစ်တပ်က
စပ်တပ်	စစ်တပ်
စစ်ဗိ်ုလ်ချုပ်	စစ်ဗိုလ်ချုပ်
စစ်ဘေးဒုက္ခသည်စခမ်း	စစ်ဘေးဒုက္ခသည်စခန်း
စစ်ရေးိပြ	စစ်ရေးပြ
စစ်ရေးပြသနာ	စစ်ရေးပြဿနာ
စစ်သွေးကြ	စစ်သွေးကြွ
စဥ်းစားကြည့်ကြပါ	စဉ်းစားကြည့်ကြပါ
စဥ်းစားကြည့်နေတာ	စဉ်းစားကြည့်နေတာ
စ႕ဉ်းစားကြည့်ပါ	စ႕ဉ်းစားကြည့်ပါ
စဉ်းစားကျိရင်	စဉ်းစားကြည့်ရင်
စဥ်းစားထားတာ	စဉ်းစားထားတာ
စဥ်းစားနေတာ	စဉ်းစားနေတာ
စဥ်စားမိတာ	စဉ်းစားမိတာ
စဥ်စားလိုက်တာပေါ့	စဉ်းစားလိုက်တာပေါ့
စဉ်စားသင့်ပြီ	စဉ်းစားသင့်ပြီ
စည်းကမ် း	စည်းကမ်း
ည်းကမ်း	စည်းကမ်း
စည်းစညိးလုံးလုံး	စည်းစည်းလုံးလုံး
စည်းဖောက်မှူ	စည်းဖောက်မှု
စီးဝေးပွဲ	စည်းဝေးပွဲ
စိတ် ကူးကောင် း	စိတ် ကူးကောင်း
စိတါကို	စိတ်ကို
စိတ်ကုန်လေဘဲ့	စိတ်ကုန်လေပဲ
စိတ်ခံစားမှု့	စိတ်ခံစားမှု
စိတ	စိတ်
စိတ်ဆင်းရဲ ရလွနး်လို့	စိတ်ဆင်းရဲ ရလွန်းလို့
စိတ်ပက်စရာ	စိတ်ပျက်စရာ
စိတ် ဖြင် ့	စိတ် ဖြင့်
စိတ်မကောင်ဖြစ်ရပါတယ်	စိတ်မကောင်းဖြစ်ရပါတယ်
စိတ်မချမ်းမြေ့	စိတ်မချမ်းမြေ့
စိတ် းကူးကောင် းတွေ	စိတ်းကူးကောင်းတွေ
စုတ်ထုတ်နေတယ်လို	စုတ်ထုတ်နေတယ်လို့လည်း
စုန်းမကြိး	စုန်းမကြီး
စမ် းသပ် ချင် သည် ့	စမ်းသပ် ချင် သည့်
စမ်းသပ်မောင်နှင်မှု	စမ်းသပ်မောင်းနှင်မှု
စုံစမ်းစစ်ဆွေးမယ့်	စုံစမ်းစစ်ဆေးမယ့်
စုံးစမ်း	စုံစမ်း
စုံစမ်းထောက်လှန်းမှု	စုံစမ်းထောက်လှမ်းမှု
စုံးစမ်းမှုမျိုး	စုံစမ်းမှုမျိုး
စုံစုံလျှင်လျှင်	စုံစုံလင်လင်
စွဲချက်တင်နိ်ုင်သောကြောင့်	စွဲချက်တင်နိုင်သောကြောင့်
စွန့်ခွါ	စွန့်ခွာ
စွန်လွတ်	စွန့်လွတ်
စွန်းစွန်းလောင်	စွန်းစွန်းလောက်
စွပ်ဆွဲထားပြီး	စွပ်စွဲထားပြီး
စွမ် းဆောင်	စွမ်းဆောင်
ဆ၇ာကြီး	ဆရာကြီး
ဆ၇ာ	ဆရာ
တရာ	ဆရာ
ဆရာ ့	ဆရာ့
ဆာကေး	ဆာတေး
ဆီု	ဆီ
ဆိီဆိုင်	ဆီဆိုင်
ဆုတဆိပ်	ဆုတံဆိပ်
ဆုတောင်းပေးကြပါအုံးဗျာ	ဆုတောင်းပေးကြပါဦးဗျာ
ဆေးရုံတွေစီ	ဆေးရုံတွေဆီ
ဆေးရုံသွားပြ ဘို ့	ဆေးရုံသွားပြဖို့
ဆဲးပေါ့	ဆဲပေါ့
စောရီးပဲ	ဆောရီးပဲ
ဆြော့ကတာဗျ	ဆော့ကြတာဗျ
ဆိုတေ	ဆို
ဆို့	ဆို
ဆိုတာ ကိုတ	ဆိုတာ ကိုက
ဆိုတေ ာ့ 	ဆိုတော့
ဆိုပေမဲ့	ဆိုပေမယ့်
ဆိုဘဲ့	ဆိုပဲ
ဆိုပီး	ဆိုပြီး
ဆိုပီးတော့	ဆိုပြီးတော့
ဆိုရင်တော	ဆိုရင်တော့
ဆို၇င်တော့	ဆိုရင်တော့
ဆိုရှယ်လစ်နဲလဲ	ဆိုရှယ်လစ်နဲ့လဲ
ဆ်ုလိုတာ	ဆိုလိုတာ
ဆိုသည် ့ 	ဆိုသည့်
ဆိုးကျိူးတွေ	ဆိုးကျိုးတွေ
စိုးဝါးနေတယ်	ဆိုးဝါးနေတယ်
ဆက်တံတာမျိုး	ဆက်ဆံတာမျိုး
ဆက်နွှယ်ဖွယ်	ဆက်နွယ်ဖွယ်
ဆပ်လုတ်	ဆက်လုပ်
ဆက်လျှောက်ရမယ်	ဆက်လျှောက်ရမယ့်
ဆက်သွယ်နိူင်ပါတယ်	ဆက်သွယ်နိုင်ပါတယ်
ဆောက်လက်ဆ	ဆောက်လက်စ
ဆိုကေ်၇ာက်ခဲ့ရပါတယ်	ဆိုက်ရောက်ခဲ့ရပါတယ်
ဆင်ခြင်မှူ	ဆင်ခြင်မှု
ဆင်ဆင်ချင်ချင်	ဆင်ဆင်ခြင်ခြင်
ဆင်ရဲခဲ့ပုံ	ဆင်းရဲခဲ့ပုံ
ဆောင်ရွက် နိ်ုင်ခြေရှိတဲ့ 	ဆောင်ရွက် နိုင်ခြေရှိတဲ့ 
ဆောင်ရွှက်ပါတယ် 	ဆောင်ရွက်ပါတယ် 
ဆိုင်ရ	ဆိုင်ရာ
ဆိုင် းပုဒ် 	ဆိုင်းပုဒ် 
ဆုပ်ယုတ် 	ဆုတ်ယုတ် 
ဆန	ဆန္ဒ
ဆုံးဖြတ်ပီး	ဆုံးဖြတ်ပြီး
ဆုံးမ မှာလည်း	ဆုံးမ မှာလဲ
ဆုံးရှူံး	ဆုံးရှုံး
ဆုံးရှုံးနစ်နစ်	ဆုံးရှုံးနစ်နာ
ဆုံးရှုံမှု	ဆုံးရှုံးမှု
ဆေ ွးနေ ွး 	ဆွေးနွေး
ဆေးွနွေးနေကြသော	ဆွေးနွေးနေကြသော
ဆွေးနွေးပွဲလေ	ဆွေးနွေးပွဲလေး
ဆေးွနွေးမယ့်	ဆွေးနွေးမယ့်
စွဲခေါ်	ဆွဲခေါ်
ဆွဲဆောင်မှု့	ဆွဲဆောင်မှု
ဆွဲထည့်ခ	ဆွဲထည့်ခြင်း
စနီးမောင်နှံ	ဇနီးမောင်နှံ
စယား	ဇယား
ဇူလိ်ုင်လ	ဇူလိုင်လ
ဇောတ်ကားများကို	ဇာတ်ကားများကို
ဇတ်စဉ်	ဇာတ်စင်
ဇတ်	ဇာတ်
ဇာတ်လမး်ကြိး	ဇာတ်လမ်းကြီး
ဇာတ်လမး်	ဇာတ်လမ်း
ဇွတ်ကြီးပါဟယ်လ်	ဇွတ်ကြီးပါဟယ်
ဈေူကွက်	ဈေးကွက်
ဈေုး	ဈေး
ဈေးတေ	ဈေးတွေ
ဈေးလျော့ချင်လျော့	ဈေးလျှော့ချင်လျှော့
ညယ်မလေး	ညီမလေး
ညီမေ လးေ ရ	ညီမလေးရေ
ည့ံတာ	ညံ့တာ
ညိုည်ိုသင်း	ညိုညိုသင်း
ညင်းပနး်နှိပ်စက်	ညင်းပန်းနှိပ်စက်
ညစ်ပါတ်တဲ့	ညစ်ပတ်တဲ့
ညဥ့်နက်	ညဉ့်နက်
ငြီးနေမယ့်	ညည်းနေမယ့်
ညှိခဲ့တာ်တွေ	ညှိခဲ့တာတွေ
ညှိနှိ်ုင်းမှု	ညှိုနိုင်းမှု
ညွှိနှိုင်းဆွေးနွေး	ညှိုနှိုင်းဆွေးနွေး
ညှိးငယ်စွာဖြင့်	ညှိုးငယ်စွာဖြင့်
ညွန်ကြားရေးမှူး	ညွှန်ကြားရေးမှူး
ဋ္ဌာန	ဌာန
တလုံးချွတ်	တကိုယ်လုံးချွတ်
တကြိ်မ်	တကြိမ်
တခါတညး်	တခါတည်း
တခါထဲ	တခါထဲ
တခါပျင်	တခါပြင်
တခု	တခု
တစ်ချို့ကြ	တချို့ကျ
တချို	တချို့
တချို ့	တချို့
တချို ့ 	တချို့
တစ်ချို	တချို့
တစ်ချို့	တချို့
တစ်ချို့	တချို့
တဂို	တဂိုး
တရိူက်မတ်မတ်	တစိုက်မတ်မတ်
တနလာနေ့	တနင်္လာနေ့
တနလာၤနေ့	တနင်္လာနေ့
တနိုင်ငတပိုင်	တနိုင်တပိုင်
တပြေညီ	တပြေးညီ
တဖက်နိုင်ငံဖက်	တဖက်နိုင်ငံဘက်
တဖြည်းြ်ဖည်းချင်း	တဖြည်းဖြည်းချင်း
တဖြေးဖြေး	တဖြည်းဖြည်း
တယောက်	တယောက်
တရားပွဲပြိးတော့	တရားပွဲပြီးတော့
တရာမဝင်	တရားမဝင်
တရားမဝင်သတ်ဖြတ်ခြငး် 	တရားမဝင်သတ်ဖြတ်ခြင်း
တရားအားထုတိခြင်းဟာ	တရားအားထုတ်ခြင်းဟာ
တရုပ်	တရုတ်
တလက်ဆတည်းမှာပဲ	တလက်စတည်းမှာပဲ
တအာင်း	တအောင်း
တာပန်	တာဝန်
တာဝန်ရှိ်သူတွေ	တာဝန်ရှိသူတွေ
တာဆီးကာကွယ်	တားဆီးကာကွယ်
တရိဆန်	တိရစ္ဆာန်
တူမှာ	တူမှ
တဲ	တဲ့
တဲံ	တဲ့
တယ်	တဲ့
တဲလေး	တဲ့လေး
ရတော့ပါသေးတယ်	တော့ရပါသေးတယ်
တော်တော်လေးတော	တော်တော်လေးတော့
တော်တယ်ဘဲ	တော်တယ်ပဲ
တော်ဘာဒေါ့အေ	တော်ပါတော့အေ
တော်ပ်တယ်	တော်ပါတယ်
တော်ဝင်အမိန်	တော်ဝင်အမိန့်
တော်သေးဘီ	တော်သေးပြီ
တကျို	တိုကျို
တို ့ ကို 	တို့ကို 
တိူ့	တို့
တိိုး	တို့
တို	တို့
တို ့	တို့
တို	တို့ဘာတို့
တိုဟာ	တို့ဟာ
တိုးမြင့်လာပါတယ်	တိုးမြှင့်လာပါတယ်
တက္ကသိ်ုလ်	တက္ကသိုလ်
တက္ကသိ်ုလ်ဝင်	တက္ကသိုလ်ဝင်
တိုင်စီခ	တက်စီခ
တက်က	တက်
တ်တတ်ကြွကြွ	တက်တက်ကြွကြွ
တက်လည်း	တက်လမ်း
တက်သွားခဲ့ပါပြီး	တက်သွားခဲ့ပြီး
တိ်ုက်ခိ်ုက်	တိုက်ခိုက်
တိ်ုက်ခိုက်	တိုက်ခိုက်
တိုက်ခိ်ုက်တဲ့	တိုက်ခိုက်တဲ့
တိုက်ခိ်ုက်နေ	တိုက်ခိုက်နေ
တိုက်ခိုုက်ပါ	တိုက်ခိုက်ပါ
တိ်ုက်ခိုက်ဖို့	တိုက်ခိုက်ဖို့
တိ်ုက်ခိုက်မှု	တိုက်ခိုက်မှု
တိုက်ခိ်ုက်မှု	တိုက်ခိုက်မှု
တိုက်ခိိုက်မှုအတွင်း	တိုက်ခိုက်မှုအတွင်း
တိုက်တိုက်ချက်	တိုက်တွန်းချက်
တိ်ုက်တွန်း	တိုက်တွန်း
တိုက်တွန်းနေပါတယ။်	တိုက်တွန်းနေပါတယ်
တိ်ုက်ပွဲ	တိုက်ပွဲ
တုက်ပွဲ	တိုက်ပွဲ
တင်ထာတယ်	တင်ထားတယ်
တင်အောင်မြင့့်ဦး	တင်အောင်မြင့်ဦး
တောင်ကိုရီးား	တောင်ကိုရီးယား
တောင်ကိုးရီးယား	တောင်ကိုရီးယား
တောက်မှန်းမြောက်မှန်ူမသိပံ	တောင်မှန်းမြောက်မှန်းမသိပဲ
တောင်ပန်လို့	တောင်းပန်လို့
တောင်ပန်အပ်ပါတယ်	တောင်းပန်အပ်ပါတယ်
တောင်မယ်	တောင်းမယ်
တို်ုင်တောင်	တိုင်တောင်
တိ်ုင်ပင်ကြပါတယ်	တိုင်ပင်ကြပါတယ်
တိုင်းတားတဲ့	တိုင်းတာတဲ့
တိုင်ပြည်ချစ်စိတ်	တိုင်းပြည်ချစ်စိတ်
တိုုင်းပြည်	တိုင်းပြည်
တိုင်းပြာ်	တိုင်းပြည်
တိုင်ရင်းသား	တိုင်းရင်းသား
တိုင်းရင်းဒေသ	တိုင်းရင်းသားဒေသ
တိုငး်ရုံး	တိုင်းရုံး
တကောင်	တစ်ကောင်
တကမ္ဘာလုံး	တစ်ကမ္ဘာလုံး
တကျော့ပြန်	တစ်ကျော့ပြန်
တကြိမ်	တစ်ကြိမ်
တခါသုံး	တစ်ခါသုံး
တ	တစ်ခု
တခု	တစ်ခု
တခုတော့	တစ်ခုတော့
တခုတည်း	တစ်ခုတည်း
တစ်ခုထည်း	တစ်ခုတည်း
တခုမှ	တစ်ခုမှ
တခုရှိပေမဲ့	တစ်ခုရှိပေမယ့်
တစ်ခုလူံး	တစ်ခုလုံး
တချိန်က	တစ်ချိန်က
တစ်ချိ်န်က	တစ်ချိန်က
တချိန်တည်း	တစ်ချိန်တည်း
တစ်ချိ်န်မှာ	တစ်ချိန်မှာ
တခွန်းတပါဒ	တစ်ခွန်းတစ်ပါဒ
တစီး	တစ်စီး
တစု	တစ်စု
တစောင်	တစ်စောင်
စတိတ်တပိုင်း	တစ်စိတ်တစ်ပိုင်း
တစ်ဆုူ	တစ်ဆူ
တတိုက်နဲ့တတိုက်	တစ်တိုက်နဲ့တစ်တိုက်
တတိုင်း	တစ်တိုင်း
တတန် 	တစ်တန် 
တထောင်နဲ့တထောင်	တစ်ထောင်နဲ့တစ်ထောင်
တဒါဇင်ကျော်	တစ်ဒါဇင်ကျော်
တနာရီ	တစ်နာရီ
တနေ့	တစ်နေ့
တစ်နေ	တစ်နေ့
တစ်နေ ့	တစ်နေ့
တနံတလျား	တစ်နံတစ်လျား
တနိုင်ငံ	တစ်နိုင်ငံ
တနိုင်ငံလုံးကို	တစ်နိုင်ငံလုံးကို
တနိုင်ငံလုံး	တစ်နိုင်ငံလုံး
တစ်နိူင်ငံလုံး	တစ်နိုင်ငံလုံး
တနည်း	တစ်နည်း
တနစ်	တစ်နှစ်
တနှစ်လုံး	တစ်နှစ်လုံး
တပါး	တစ်ပါး
တပင်မှ	တစ်ပင်မှ
တပတ်စာ	တစ်ပတ်စာ
တပတ်	တစ်ပတ်
တပတ်တကြိမ်	တစ်ပတ်တစ်ကြိမ်
တပုံ	တစ်ပုံ
တပိသာ	တစ်ပိဿာ
တပွဲလုံး 	တစ်ပွဲလုံး 
တဖက်	တစ်ဖက်
တဘက်	တစ်ဖက်
တစ်ဘက်	တစ်ဖက်
တဖုံ	တစ်ဖုံ
တဖွဲ့ချင်း	တစ်ဖွဲ့ချင်း
တဖွဲ့	တစ်ဖွဲ့
တမျိုး	တစ်မျိုး
တမျက်နှာ	တစ်မျက်နှာ
တမျက်နှာတည်း	တစ်မျက်နှာတည်း
တယူနစ်	တစ်ယူနစ်
တယောက်ချင်းစီ 	တစ်ယောက်ချင်းစီ 
တယောက်ချင်း	တစ်ယောက်ချင်း
တယောက်	တစ်ယောက်
တယောက်တည်းသော	တစ်ယောက်တည်းသော
တျောက်	တစ်ယောက်
တယောက်နှုန်း	တစ်ယောက်နှုန်း
တျောက်ချစ်ဦိးမလား	တစ်ယောက်ရှိဦးမလား
တရက်စာ	တစ်ရက်စာ
တရက်	တစ်ရက်
တရပ်တာ	တစ်ရက်တာ
တရပ်	တစ်ရပ်
တရုံ	တစ်ရုံ
တလ	တစ်လ
တစ်လင်တမယား	တစ်လင်တစ်မယား
တလိုင်ချင်းစီ	တစ်လိုင်းချင်းစီ
တလိပ်	တစ်လိပ်
တလျှောက်	တစ်လျှောက်
တဝိုက်	တစ်ဝိုက်
တသီးပုဂ္ဂလ	တစ်သီးပုဂ္ဂလ
တစ်သံတညး်	တစ်သံတည်း
တသန်း	တစ်သန်း
တသိန်း	တစ်သိန်း
တစ်ဉီးချင်းစီ	တစ်ဦးချင်းစီ
တဉီး	တစ်ဦး
တဦး 	တစ်ဦး 
တဦး	တစ်ဦး
တစ်ဉီး	တစ်ဦး
တဦးတယောက်	တစ်ဦးတစ်ယောက်
တဦးတည်းပိုင်	တစ်ဦးတည်းပိုင်
တဦးတည်းသော 	တစ်ဦးတည်းသော 
တအိမ်	တစ်အိမ်
တည်ဆောကြ်က	တည်ဆောက်ကြ
တည်းဆောက်ထားပါတယ်	တည်ဆောက်ထားပါတယ်
တည်ထည်ဆိုတာ	တည်တယ်ဆိုတာ
တည်ဖြတ်	တည်းဖြတ်
တက်နိုင်	တတ်နိုင်
တတ်နိင်ဦး	တတ်နိုင်ဦး
တိတ်တစိတ်	တိတ်တဆိတ်
တန်ဖိုးမဖြတ်နိူင်	တန်ဖိုးမဖြတ်နိုင်
တုံးကလို	တုန်းကလို
တပ်ဖွဲ	တပ်ဖွဲ့
တပ်မတာ်	တပ်မတော်
တပ်မတော်ဖက်က	တပ်မတော်ဘက်က
တိမ်းရှောင်သွား	တိမ်းရှောင်သွားတာ
တုန့်ပြန်	တုံ့ပြန်
တယါ	တယ်
တယ်လီဖုန်	တယ်လီဖုန်း
ဒေက	တွေက
တေကိုတိုင်	တွေကိုယ်တိုင်
အတွေကြားထဲ	တွေကြားထဲ
တွေေ	တွေကြောင့်
တေ	တွေ
ဒေ	တွေ
တွေ ့ ကရာ	တွေ့ကရာ
တွေ ့ခဲ့တဲ့ 	တွေ့ခဲ့တဲ့ 
တွေ့ချင်းလို့	တွေ့ချင်လို့
တွေ	တွေ့ဆုံခဲ့ပြီး
တွေ ့ဆုံ 	တွေ့ဆုံ 
တွေ့စုံသည်	တွေ့ဆုံသည်
တွေ ့တယ်	တွေ့တယ်
တွေ ့	တွေ့
တွေနေရတော့	တွေ့နေရတော့
တွေ့ပါပီ	တွေ့ပါပြီ
တြွေ့ပီး 	တွေ့ပြီး 
တွေ ့ရင်	တွေ့ရင်
တွေ့ရှိမဲ့	တွေ့ရှိမယ့်
တွေး့လိုက်ရင်	တွေးလိုက်ရင်
တွေးလိမ် ့မယ် 	တွေးလိမ့်မယ် 
တွေးလိမ် ့မယ်	တွေးလိမ့်မယ်
တွဲပီး	တွဲပြီး
တွဲးပြီး	တွဲပြီး
တွက်ကြ်ည့် တော့ 	တွက်ကြည့် တော့ 
တွန်းားပေးနိုင်	တွန်းအားပေးနိုင်
ထပီး	ထပြီး
ထဘိ	ထဘီ
ထရန်ံ	ထရန်ပ်
ထားပီး	ထားပြီး
ထား၇တာ	ထားရတာ
ထိခိ်ုင်နဟ်နာနိုင်ခြင်း	ထိခိုက်နစ်နာနိုင်ခြင်း
ထူးထောင်ရေး	ထူထောင်ရေး
ထဲမှာ့	ထဲမှာ
ထိုးဖောက် ခြငး် 	ထိုးဖောက် ခြင်း
ထက်ဆာရင်	ထက်စာရင်
ထက်ပြီ	ထက်ပြီး
ထောက်ခံထာပါတယ်	ထောက်ခံထားပါတယ်
ထင်တင်	ထင်တယ်
ထင်ရပေမဲ့	ထင်ရပေမယ့်
ထာင်ကျော်ရှိ	ထောင်ကျော်ရှိ
ထောင်ဒါဏ်	ထောင်ဒဏ်
ထောင်ပေါင်းများစွာသူ	ထောင်ပေါင်းများစွာသောသူ
ထိ်ုင်း	ထိုင်း
ထည် ့ထားသည် 	ထည့်ထားသည် 
ထုတ်ထာတာ	ထုတ်ထားတာ
ထုန်ပြန်လိုက်တယ်	ထုတ်ပြန်လိုက်တယ်
ထုတ်ဖေါ်	ထုတ်ဖော်
ထုတ်လုပ်နိူင်ပါသေးတယ်	ထုတ်လုပ်နိုင်ပါသေးတယ်
ထုတ် လုပ် ရောင် းခြင် း	ထုတ် လုပ် ရောင်းခြင်း
ထိန်းကြောင်း	ထိန်းကျောင်း
ထိန်းချုပ်နိ်ုင်တာ	ထိန်းချုပ်နိုင်တာ
ထိန်းချုပ်နိ်ုင်တာမျိုး	ထိန်းချုပ်နိုင်တာမျိုး
ထိန်းချုပ်နိ်ုင်	ထိန်းချုပ်နိုင်
ထိန်းဆင်းပါတယိ	ထိန်းဆင်းပါတယ်
ထေနိုင်မှာ	ထိန်းနိုင်မှာ
ထိမ်းမ နိမ်တဲ့	ထိန်းမ နိုင်တဲ့
ထိ်မ်းသိမ်း	ထိန်းသိမ်း
ထိန်းသိ်မ်းရေး	ထိန်းသိမ်းရေး
ထိမ်းသိမ်းရေးု	ထိန်းသိမ်းရေး
ထပ်တက်နေအုံးမှာ	ထပ်တက်နေဦးမှာ
ထက်ဖြည့်ဖို့	ထပ်ဖြည့်ဖို့
ထပ်မံင်ပေါ်ချင်သေးသည် 	ထပ်မံပေါ်ချင်သေးသည် 
ထိပ်ပိ်ုင်း	ထိပ်ပိုင်း
ထကွ်ကုန်	ထွက်ကုန်
ထွက်ခွါ	ထွက်ခွာ
ထကွ်ပေါက်ရမယ်	ထွက်ပေါက်ရမယ်
ထွွက်လာခဲ့ပါတယ်	ထွက်လာခဲ့ပါတယ်
ထွက်သွားပြီး	ထွက်သွားပြီ
ထွတိးကားတဲ့	ထွန်းကားတဲ့
ထွန်းမြတ်နိူင်	ထွန်းမြတ်နိုင်
ထွန်းအိန္ဒြဗို	ထွန်းအိန္ဒြာဗိုလ်
ဒါကလည်	ဒါကလည်း
ဒါကလည်ဒ	ဒါကလည်း
ဒါကိ်ု 	ဒါကို
ါဆိုရင်	ဒါဆိုရင်
ဒါပေမဲ့	ဒါပေမယ့်
ဒါဘဲကြ	ဒါပဲကြ
ဒါမဲ့	ဒါမယ့်
ဒါမဲ့ 	ဒါမယ့်
ဒများါ	ဒါများ
ဒါတာ	ဒါဟာ
ဒါ	ဒါ့
ဒါအပြင်	ဒါ့အပြင်
ဒါအအပြင်	ဒါ့အပြင်
ဒီဇိ်ုင်း	ဒီဇိုင်း
ဒီဇိုင်းမျ ို း 	ဒီဇိုင်းမျိုး 
ဒိီ	ဒီ
ဒီပါတ်	ဒီပတ်
ဒီမိုကရေစိီ	ဒီမိုကရေစီ
ဒီမိုခရေဇီး	ဒီမိုကရေစီ
ဒိီလို	ဒီလို
ဒီလို	ဒီလို
ဒီလို့	ဒီလို
ဒီလိုဘဲ	ဒီလိုပဲ
ဒီလောက်ထိကျ	ဒီလောက်ထိကြ
ဒေသာ	ဒေတာ
ဒေါသလည်းမထွက်ချင်ပု	ဒေါသလည်းမထွက်ချင်ဘူး
ဒေါသသံပါမှာဆိုး	ဒေါသသံပါမှစိုး
ဒေါ ်	ဒေါ်
 ေါ်လာ	ဒေါ်လာ
ဒေါ်အောင်ဆနး်စုကြည်	ဒေါ်အောင်ဆန်းစုကြည်
ဒေါ်အောင်ဆန်စုကြည်	ဒေါ်အောင်ဆန်းစုကြည်
ဒွတ်ခ	ဒုက္ခ
ဒုက္မြသည်တွေ	ဒုက္ခသည်တွေ
ဒုက္ခသည	ဒုက္ခသည်
ဒုက္ခည်	ဒုက္ခသည်
ဒါဏ်ခက် 	ဒဏ်ခက် 
ဒ႑ဏ္ဍာရီ	ဒ႑ဏ္ဍာရီ
ဒဿဂီိရိ	ဒဿဂီရိ
ဓာတ်ဆြာ	ဓာတ်ဆရာ
ဓါတ်ထားနေပါ	ဓာတ်ထားနေပါ
ဓါတ်ပုံတေ ွ	ဓာတ်ပုံတွေ
ဓါတ်ပုံ	ဓာတ်ပုံ
ဓာတ်ပုံရိုက်မဲ့	ဓာတ်ပုံရိုက်မယ့်
ဓမ်္မိယလဒ္ဓ	ဓမ္မယိလဒ္ဓ
နဂိုလ်အတိုင်း	နဂိုအတိုင်း
နမူနာကွဲ ့.	နမူနာကွယ့်
နာဂတ်မုန်တိုင်း	နာဂစ်မုန်တိုင်း
နာမည်ကျေ	နာမည်ကျော်
နံမယ်ကျော်	နာမည်ကျော်
နံမယ်ကြီး	နာမည်ကြီး
နာမယ်ဆိုး	နာမည်ဆိုး
နာမယ်	နာမည်
နံမည်	နာမည်
နံမယ်	နာမည်
နံမယ်ပျက်	နာမည်ပျက်
နံမည်ပျက်ဖို့	နာမည်ပျက်ဖို့
နရာရီ	နာရီ
ရ နာရိီ	၇ နာရီ
ဝ၀း၃၀ နာရီ	၀၀:၃၀ နာရီ
နာညးထောင်နေစဉ်	နားထောင်နေစဉ်
နားမလည်း	နားမလည်
နားလည်းကြရဲ့လား	နားလည်ကြရဲ့လား
နားလည်ခဲ့၇တယ်	နားလည်ခဲ့ရတယ်
နားလည်း	နားလည်
နားလည်မှု့	နားလည်မှု
နိဂုန်းချုပ်ရရင်	နိဂုံးချုပ်ရရင်
နီးပါးကြား	နီးပါးကြာ
နိးပါးလောက်	နီးပါးလောက်
နေကောင်အောင်လုပ်ပီး	နေကောင်းအောင်လုပ်ပြီး
နေစဥ	နေစဉ်
နေးတိုး	နေတိုး
နေထိ်ုင်နေတဲ့	နေထိုင်နေတဲ့
နေပြိး	နေပြီး
နေ့ဖို့	နေဖို့
နေမကောငး်	နေမကောင်း
နေရာမှ ာ	နေရာမှာ
ရော	နေရာ
နေရာရွှေ ့ပြောင်းမှုတွေ	နေရာရွှေ့ပြောင်းမှုတွေ
နေရင်ကော	နေရင်ရော
နေအိ်မ်	နေအိမ်
နေ့ခင်	နေ့ခင်း
နေ့ခင်ဖက်	နေ့ခင်းဖက်
နေ ့ည 	နေ့ည 
နေ ့တိုင်း 	နေ့တိုင်း 
နေ ့	နေ့
နေ ့	နေ့
တဲ့	နဲ့
နဲ	နဲ့
နဲပ	နဲ့
နဲ့	နဲ့
နဲ ့	နဲ့
နဲ့ ့	နဲ့
နဲ့ဘဲး	နဲ့ပဲ
နဲ ့လဲ 	နဲ့လည်း
နဲ ့ အတူ 	နဲ့အတူ 
နံပတ် 	နံပါတ် 
နံပတ်	နံပါတ်
နဘေးမှာ	နံဘေးမှာ
နိ်ုဝင်ဘာ	နိုဝင်ဘာ
နက်နက်တငွ်းကြီး	နက်နက်တွင်းကြီး
နက်နက်ရိူင်းရိူင်း	နက်နက်ရှိင်းရှိင်း
နက်ရှိူင်းတယ်	နက်ရှိင်းတယ်
နောက်ကြော	နောက်ကျော
နောက်ဆုံ့းတော့ 	နောက်ဆုံးတော့ 
နောက်နေတာဘဲ့	နောက်နေတာပဲ
နောက်နေ	နောက်နေ့
နောက	နောက်
နောက်နစ်	နောက်နှစ်
နောက်ပိ်ုင်း	နောက်ပိုင်း
နောက်လ	နောက်လလျှပ်စစ်
နင့်ကြည့်လျင်	နင့်ကြည့်လျှင်
နိူင်င ံခြား	နိုင်ငံခြား
နိုင်ငံခြာ	နိုင်ငံခြား
နိုင်ငံခြာူ	နိုင်ငံခြား
နိ်ုင်ငံခြားရေး	နိုင်ငံခြားရေး
နိ်ုင်ငံတကာ	နိုင်ငံတကာ
နိူင်ငံတကာ	နိုင်ငံတကာ
နိုင်ငံကတာ	နိုင်ငံတကာ
နိူင်ငံတကာပွဲ	နိုင်ငံတကာပွဲ
နိူင်ငံတဝှမ်း 	နိုင်ငံတဝှမ်း 
နိုင်ငံတော	နိုင်ငံတော်
နှိုင်ငံတော်	နိုင်ငံတော်
နိ်ုင်ငံတိုင်း	နိုင်ငံတိုင်း
နိ်ုင်ငံ	နိုင်ငံ
နိူင်ငံ 	နိုင်ငံ 
နိူင်ငံ	နိုင်ငံ
နို်ုင်ငံ	နိုင်ငံ
နိင်ငံ	နိုင်ငံ
နိုင်ငံ့	နိုင်ငံ
နိုင်ငံဖက် 	နိုင်ငံဘက်
နိ်ုင်ငံရေး	နိုင်ငံရေး
နိူင်ငံရေး	နိုင်ငံရေး
နိုင်င့ရေး	နိုင်ငံရေး
နိ်ုင်ငံသား	နိုင်ငံသား
နှိင်သူ	နိုင်သူ
နိုင်ယှည်သင်ု့ပီး	နိုင်းယှဉ်သင့်ပြီး
နစ်မြှပ်	နစ်မြှပ်
နည်း	နည်းနဲ့
နည်းနညး်	နည်းနည်း
နည် းနည် း	နည်းနည်း
နညး်ပညာ	နည်းပညာ
နည်းဘဲသုံးနေကြဆဲပါ	နည်းပဲသုံးနေကြဆဲပါ
နည် းလမ် း	နည်းလမ်း
နဲသေး	နည်းသေး
နည် းသည့် 	နည်းသည့် 
နုန်းမြေနု	နုံးမြေနု
နပ်ဖြတ်ပြီး	နယ်ဖြတ်ပြီး
နျကလီးယား	နျူကလီယား
နျူကလီယာ	နျူကလီးယား
နွားနို	နွားနို့
နမချင်း	နှမချင်း
နှမခြင်း	နှမချင်း
နှမျှော်တာပါဟာ	နှမျောတာပါဟာ
နှာခေါင်းရူံ့	နှာခေါင်းရှုံ့
နှာဘူးထတက်တဲ့	နှာဘူးထတတ်တဲ့
နင့်	နှင့်
နှင် ့ 	နှင့် 
နှင် ့	နှင့်
နှင့့်	နှင့်
နှင် ့ူ	နှင့်
နင်း	နှင်း
နှိုုင်းယှဉ်	နှိုင်းယှဉ်
နှိုင်းယှာဉ်	နှိုင်းယှဉ်
နှိုင်ယှဉ်ဖို့	နှိုင်းယှဉ်ဖို့
နှိုင်းယှဉ်ရင်ု	နှိုင်းယှဉ်ရင်
နှိူင်းယှဉ်သုံးသပ်ပါ	နှိုင်းယှဉ်သုံးသပ်ပါ
၉	၉နှစ်
န📲📲စ်စဉ်	📲📲နှစ်စဉ်
နစ်ဆ	နှစ်ဆ
နှစ်နိ်ုင်ငံ	နှစ်နိုင်ငံ
နစ်	နှစ်
နှစိ	နှစ်
နှစ်မြုတ်မှု	နှစ်မြှပ်မှု
နှစ်ဟောင်	နှစ်ဟောင်း
နှစ်ဉီး	နှစ်ဦး
နှုခမ်း	နှုတ်ခမ်း
နှတ်ထွက်တယ်လို့ 	နှုတ်ထွက်တယ်လို့ 
နိတ်ပြီး	နှိပ်ပြီး
နှီမ်ချ	နှိမ်ချ
နှိမ်းနှင်းတာတော့	နှိမ်နင်းတာတော့
နှိ်မ်နှင်းရေး	နှိမ်နှင်းရေး
ပညာတက်	ပညာတတ်
ပညာတက်	ပညာတတ်
ပညာရေးစနစေ်	ပညာရေးစနစ်
ပြင်ညာရှင်တွေ	ပညာရှင်တွေ
ပဠိက္ခ	ပဋိပက္ခ
ပမထ	ပထမ
ပထမဉီးဆုံး	ပထမဦးဆုံး
ပဒေသရာဇာ်	ပဒေသရာဇာ
ပြိတ်သတ်ကြီး	ပရိသတ်ကြီး
ပြိန်သတ်ဂျီးများ	ပရိသတ်ကြီးများ
ပရိဿတ်	ပရိသတ်
ပလောဂျက်	ပရော့ဂျက်
ပလစ်စတစ်	ပလတ်စတစ်
ပလပ်စစ်	ပလပ်စတစ်
ပါကစ္စတ်	ပါကစ္စတန်
ပါတီရဲ ့	ပါတီရဲ့
ပါပဲလှေ	ပါပဲလေ
မပါဝင်တာ	ပါဝင်တာ
ပါဝင်လာမူ့	ပါဝင်လာမှု
ပါမလဲ	ပါ့မလဲ
ပါစပ်	ပါးစပ်
ပီတြိဖစ်ပီး 	ပီတိဖြစ်ပြီး 
ပုဂံခောက်	ပုဂံခေတ်
ပူးပေါင်းဆောင်ရွကိ်ု့	ပူးပေါင်းဆောင်ရွက်ဖို့
ပေမဲ့	ပေမယ့်
ပေမယ် ့	ပေမယ့်
ပေးကျ	ပေးကြ
ပေးထားကောငး် 	ပေးထားကောင်း
ပေးနိူင်မယ်ဆိုရင်	ပေးနိုင်မယ်ဆိုရင်
ပေးဖ ို့	ပေးဖို့
ထွက်မပေးသင့်ပါ	ပေးမထွက်သင့်ပါ
ပေးမာလဲ	ပေးမှာလဲ
ပေယုံပဲလေ	ပေးရုံပဲလေ
ပေးလိ်ုက်ချင်	ပေးလိုက်ချင်
ပေးသွားနိ်ုင်	ပေးသွားနိုင်
ဘဲ	ပဲ
ပိုတိုးမြင့်ပြီး	ပိုတိုးမြှင့်ပြီး
ပိုတက်ပြီး	ပိုတတ်ပြီး
ပိုမို့	ပိုမို
ပိုလို့ ့	ပိုလို့
ပိုဆောင်သူ	ပို့ဆောင်သူ
ပိုမရ	ပို့မရ
ပို	ပို့လိုက်တာလို့
ပေါက်ခဲ့ပါရဲ ့လား	ပေါက်ခဲ့ပါရဲ့လား
ပိုက်�ဆံ	ပိုက်ဆံ
ပိုက်ဆံရ ဒါက	ပိုက်ဆံရ တာက
ပုဂ်္ဂိုလ်	ပုဂ္ဂိုလ်
ပုဂ်္ဂိုလ်များ	ပုဂ္ဂိုလ်များ
ပင်ပန်းသာ	ပင်ပန်းတာ
ပင်လယ်ကူး ် 	ပင်လယ်ကူး 
ပင်လာ်ကမ်းခြေ	ပင်လယ်ကမ်းခြေ
ပင်လယ်လှိ်ုင်း	ပင်လယ်လှိ်ုင်း
ပေါက်းစုံရှိတတ်တယ်	ပေါင်းစုံရှိတတ်တယ်
ပိ်ုင်တယ်	ပိုင်တယ်
ပိ်ုင်နက်	ပိုင်နက်
ပိုင်မဲ့ဟာ	ပိုင်မယ့်ဟာ
ပစည်	ပစ္စည်း
ပစည်း	ပစ္စည်း
ပစ္စည်	ပစ္စည်း
ပစ္စည် း	ပစ္စည်း
ပြစ်တာဘဲဟား	ပစ်တာဘဲဟာ
ပြစ်တဲ့	ပစ်တဲ့
ပြစ်တဲ့ အမြောက်ရဲ ့	ပစ်တဲ့ အမြောက်ရဲ့
ပြစ်ထား	ပစ်ထား
ပြစ်ထည့်လိုက်မယ်	ပစ်ထည့်လိုက်မယ်
ပု	ပုဏ္ဏားကျွန်း
၄ပါတ်	၄ပတ်
ပါတ်	ပတ်
ပတ်ဝယ်လိူက်ရသေးတယ်	ပတ်ဝယ်လိုက်ရသေးတယ်
ပါတ်သက်	ပတ်သက်
ပါတ်သက်ပြီး	ပတ်သက်ပြီး
ပါတ်သက်လို့	ပတ်သက်လို့
သက်	ပတ်သက်
ပါတ်သတ်တဲ့	ပတ်သတ်တဲ့
ပိတ်ဆိုမူ	ပိတ်ဆို့မှု
ပိတ်ပင်ထားစဲရှိလား	ပိတ်ပင်ထားဆဲရှိလား
ပိ်တ်ပင်	ပိတ်ပင်
ပိတ်ပင်လိ်ုက်တာဟာ	ပိတ်ပင်လိုက်တာဟာ
ပိတ် ပင် လိမ် ့မယ်	ပိတ် ပင် လိမ့်မယ်
ပိ်တ်မိနေ	ပိတ်မိနေ
ပုတ်ခတ်နိူင်ကြပါစေ 	ပုတ်ခတ်နိုင်ကြပါစေ 
ပုဒ်မှ 	ပုဒ်မ
ပန်းကြားထား	ပန်ကြားထား
ပန်းရဲ့လမ်း	ပန်းရဲလမ်း
ပုန်ကန်မှူ	ပုန်ကန်မှု
ပုန်းခိ်ု	ပုန်းခို
ပုံစနုံ်	ပုံစံ
ပုံသဏာန်	ပုံသဏ္ဌာန်
ပုံသန်	ပုံသဏ္ဌာန်
ပုုံး	ပုံး
ပျက်ဆီးခြင်း	ပျက်စီးခြင်း
ပျက်ဆီးတာ	ပျက်စီးတာ
ပျက်ဆီး	ပျက်စီး
ပျက်ဆီးမှု	ပျက်စီးမှု
ပျက်ဆီးလာပြီး	ပျက်စီးလာပြီး
ပျောက်လိမ့့်မယ်	ပျောက်လိမ့်မယ်
ပြခွ ွင့်ရကြတယ်	ပြခွင့်ရကြတယ်
ပြဌာန်	ပြဌာန်း
ပြဠန်း	ပြဌာန်း
ပြေနေတဲ့	ပြနေတဲ့
ပြသရင်းသား	ပြရင်းသား
ပြလက်တေးဓယ် ဘျ	ပြလိုက်သေးတယ်ဗျ
ပြာပေမဲ့	ပြာပေမယ့်
ပီးတဲ့နောက်	ပြီးတဲ့နောက်
ပြိးတော့	ပြီးတော့
ပြီးေ	ပြီးနောက်
ပီးနိုင်လဲ	ပြီးနိုင်လဲ
ပီး	ပြီး
ပြီးပြည့်စုအောင် 	ပြီးပြည့်စုံအောင် 
ပြိီးမှ	ပြီးမှ
ပြီးသွားပြီး	ပြီးသွားပြီ
ပြ ုနိုင်ပါေ စေ နာ် 	ပြုနိုင်ပါစေနော်
ပြုပြင် နိုင် စွမ် းရှိခြင် း	ပြုပြင် နိုင် စွမ်းရှိခြင်း
ပြုပြင်ဘို့	ပြုပြင်ဖို့
ပြုလုပ် နေသည် ့ 	ပြုလုပ် နေသည့်
ပြောဆိုခြ့သလို	ပြောဆိုခဲ့သလို
ပြောဆိုလိ်ုက်တာပါ။	ပြောဆိုလိုက်တာပါ။
ပြေားတာ	ပြောတာ
ပြောတါလဲ	ပြောတာလဲ
ပြောပြိုက်	ပြောပလိုက်
ပြေပါတယ်	ပြောပါတယ်
ပြာပြနေတဲ့	ပြောပြနေတဲ့
ပြောပြနိူင်	ပြောပြနိုင်
ပြောနပြီး	ပြောပြပြီး
ပြောပြမှင်္ပါ	ပြောပြမှပါ
ပြောပြသင် ့သည် ့	ပြောပြသင့်သည့်
ပြေရရင်	ပြောရရင်
ပြောလက်မှဖြင့်	ပြောလိုက်မှဖြင့်
ပြောလိုက်သေတယ် 	ပြောလိုက်သေးတယ် 
ပြောသင့်ဆယ်﻿	ပြောသင့်တယ်
ပြောသွားူတာ	ပြောသွားတာ
ပျိုကြတာ	ပြိုကြတာ
ပြိုကြမူ	ပြိုကြမှု
ပြင် ဆင် ် ချိန်	ပြင်ဆင်ချိန်
ပြင်စဉ်	ပြင်ဆင်
ပြင်ဆင်မူ့	ပြင်ဆင်မှု
ပြင်ပီးသလောက်	ပြင်ပြီးသလောက်
ကြောင်းတော့	ပြောင်းတော့
ပြောင်ပေး	ပြောင်းပေး
ပြောင်းရွှေ ့	ပြောင်းရွှေ့
ပြောလဲ	ပြောင်းလဲ
ပြောင် းလိုက် သည် 	ပြောင်းလိုက် သည် 
ပြိုင်တိုင်	ပြိုင်တိုင်း
ပြိုင်လက်	ပြိုင်ဘက်
ပြစ်တင် ရှု ံ့ချ	ပြစ်တင် ရှုံ့ချ
ပြစ်ဒါဏ်	ပြစ်ဒဏ်
ပြည်သူ ့ဆေးရုံကြီး	ပြည်သူ့ဆေးရုံကြီး
ပြည့်မြောက်ပီ	ပြည့်မြောက်ပြီ
ပြည့်မီတဲ့	ပြည့်မှီတဲ့
ပျက်လက်နေတာ	ပြတ်လပ်နေတာ
ပြန်ဆပ်ဖု့ိ 	ပြန်ဆပ်ဖို့
ပြန်တိုက်ယုမှ	ပြန်တိုက်ယူမှ
ပျံနိုင်မှာ	ပြန်နိုင်မှာ
ပြနါပြန်ဖတ်ပေး	ပြန်ပြန်ဖတ်ပေး
ပြန်မပြောရဲ့	ပြန်မပြောရဲ
ပြန် ရလာသည် ့ 	ပြန် ရလာသည့်
ပြန်ရေွးနိုင်ဖို့	ပြန်ရွေးနိုင်ဖို့
ပြန်၇ှာတွေပေမဲ့	ပြန်ရှာတွေ့ပေမယ့်
ပြန်လာပြိး	ပြန်လာပြီး
ပြန်လညဲ်ပြီး	ပြန်လည်ပြီး
ပြည်လည်ခံရေး	ပြန်လည်လက်ခံရေး
ပြည်လည်လက်ခံရေး	ပြန်လည်လက်ခံရေး
ပြန်သွှင်း	ပြန်သွင်း
ပျံ့ကျဲ	ပြန့်ကျဲ
ပြန့်ကျဲ	ပြန့်ကြဲ
ပြသနာကြီး	ပြဿနာကြီး
ပြသနာတက်မှာဆိုးပြီး 	ပြဿနာတက်မှာစိုးပြီး 
ပြတ်သနာတွေ	ပြဿနာတွေ
ပြသန	ပြဿနာ
ပြသနာ	ပြဿနာ
ပြသာနာ	ပြဿနာ
ပွားများပိူ့	ပွားများဖို့
ပွဲတော်တည်နိူင်ပါတော့မယ်	ပွဲတော်တည်နိုင်ပါတော့မယ်
ပျှော်ရွှင်မှု	ပျှော်ရွှင်မှု
ဖျန့်	ဖရန့်
ဖျန့်ဖြစ်ချင်လို့	ဖရန့်ဖြစ်ချင်လို့
ဖျန့်လစ်စ်	ဖရန့်လစ်စ်
ဖါဆွမ်	ဖာဆွမ်
_ာသည်မ	ဖာသည်မ
ဖါးကန့်	ဖားကန့်
ဖားအောက်ေတာရ	ဖားအောက်တောရ
ဖိနှိ်ပ်ခံရမှု	ဖိနှိပ်ခံရမှု
ဖူးဖူးမူတ်	ဖူးဖူးမှုတ်
ဖေဖေါ်ဝါရီလ	ဖေဖော်ဝါရီလ
ဖေ့သားဂျိိီး	ဖေ့သားကြီး
ဖေ့ဘုတ်	ဖေ့စ်ဘုတ်ခ်
ဖေါ်စေချင်တယ်	ဖော်စေချင်တယ်
ဖေါ်ဆောင်ဖြင်း	ဖော်ဆောင်ခြင်း
ဖော်ဆော်နိူင်ချက်	ဖော်ဆောင်နိုင်ချက်
ဖေါ်ထုတ်နိုင်	ဖော်ထုတ်နိုင်
ဖေါ်ထုတ်	ဖော်ထုတ်
ဖေါ်ထုတ်သူ	ဖော်ထုတ်သူ
ဖေါ်ပြခဲ့ကြပြီး	ဖော်ပြခဲ့ကြပြီး
ဖေါ်ပြခဲ့ပါတယ်	ဖော်ပြခဲ့ပါတယ်
ဖေါ်ပြခဲ့	ဖော်ပြခဲ့
aဖာ်ပြထား	ဖော်ပြထား
ဖေါ်ပြထားတဲ့	ဖော်ပြထားတဲ့
ဖေါ်ပြထားပါတယ်	ဖော်ပြထားပါတယ်
ဖေါ်ပြ	ဖော်ပြ
ထို့	ဖို့
ဖု့ိ	ဖို့
ဖို့	ဖို့
ဖို ့	ဖို့
ဖို့ ့	ဖို့
ဘို့	ဖို့
မို	ဖို့
ဖတ်လေးတွေနဲ့	ဖက်လေးတွေနဲ့
ဖေါက်ခွဲရေး	ဖောက်ခွဲရေး
ဖေါက်စားတယ်	ဖောက်စားတယ်
ဖျင်လန်ပြပြီး	ဖင်လန်ပြပြီး
ဖာ်ဆောင်ပေး	ဖောင်ဆောင်ပေး
ဖီုင်	ဖိုင်
ဖတ်ကြပြပါတယ်	ဖတ်ပြကြပါတယ်
ဖိိတ်ကျွေးခြင်း	ဖိတ်ကျွေးခြင်း
ဖုနး်	ဖုန်း
ဖမ်းခံ၇တာလို့ 	ဖမ်းခံရတာလို့ 
ဖမ်းမမိ်သေးတဲ့	ဖမ်းမမိသေးတဲ့
ဖမ်မမိသေး	ဖမ်းမမိသေး
ပျက်စီး	ဖျက်ဆီး
ဖြတ်စီး	ဖျက်ဆီး
ဖျက်စီးရာ	ဖျက်ဆီးရာ
ဖျတ်ဆီးလိုက်တဲ့	ဖျက်ဆီးလိုက်တဲ့
ဖျက်ပြီ	ဖျက်ပြီ
ဖြေရှင်ရမပေါ့မ	ဖြေရှင်းရမှာပေါ့
ဖြစ်ကုန်တာပေါ်	ဖြစ်ကုန်တာပေါ့
ဖြစ်ခဲ့ရသည”်	ဖြစ်ခဲ့ရသည်
ဖြစ်စ	ဖြစ်စေ
ဖြစ်နေ တာကြောင်	ဖြစ်နေ တာကြောင့်
ဖြစ်နေပြိ	ဖြစ်နေပြီ
ဖစ်နေမှာဆိုးလို့	ဖြစ်နေမှာစိုးလို့
ဖြစ်နေလို	ဖြစ်နေလို့
ဖစ်နိုင်ရင် 	ဖြစ်နိုင်ရင် 
ဖြစ် နိ်ုငေ်သာ	ဖြစ် နိုင်သော
ဖစ်ပျက်နေတာ	ဖြစ်ပျက်နေတာ
ဖြစ်ပြိး	ဖြစ်ပြီး
ဖြစ်ပွါးခဲ့တာဟာ	ဖြစ်ပွားခဲ့တာဟာ
ဖြစ်ပွါး	ဖြစ်ပွား
ဖြစ်ဖို ့ 	ဖြစ်ဖို့
ဖြသ်ဖို့	ဖြစ်ဖို့
ဖြစ်မဲ့	ဖြစ်မယ့်
ဖစ်ရတယ်	ဖြစ်ရတယ်
ဖြစ်လာနိ်ုင်	ဖြစ်လာနိုင်
ဖြစ်လာ	ဖြစ်လာမှာ
ဖြစ် လိမ် ့မယ်	ဖြစ် လိမ့်မယ်
ဖြစ်သလို	ဖြစ်သလို
ဖြစ်သွားပီ	ဖြစ်သွားပြီ
ဖြစ်ရေးပါ	ဖြည့်ရေးပါ
ဖြတ် စီးပြစ် လိမ် ့မယ်	ဖြတ် စီးပြစ် လိမ့်မယ်
ဖြုချခဲ့တာ	ဖြုတ်ချခဲ့တာ
ဖွဲ့စညး်ရာတွင်	ဖွဲ့စည်းရာတွင်
ဖွဲ	ဖွဲ့
ဖြွံ့ဖိုးရေး	ဖွံ့ဖြိုးရေး
ဖွငိ့ချပြတာပါ	ဖွင့်ချပြတာပါ
ဖွင့််	ဖွင့်
ဗီဒယို	ဗီဒီယို
ဗစ်နစ်ဖွဲဖား	ဗစ်နစ်ဇွဲလား
ဗိ်ုလ်ချုပ်ကြီး	ဗိုလ်ချုပ်ကြီး
ဗိ်ုလ်ချုပ်မှုးကြီး	ဗိုလ်ချုပ်မှုးကြီး
ဗိ်ုလ်မှူးကြီး	ဗိုလ်မှူးကြီး
ဗျိ ု့	ဗျို့
ဗြိတိ	ဗြိတိသျှ
ဗြိတိ်န်နိ်ုင်ငံ	ဗြိတိန်နိုင်ငံ
ဗြိတိတ်	ဗြိတိန်
ဘကြိး	ဘကြီး
ဘကြိးရဲ့ဇာတ်လမး်ကလည်း 	ဘကြီးရဲ့ဇာတ်လမ်းကလည်း 
ဘရားဇီးမြီု့	ဘရားဇီးမြို့
ဘာကြောင်း	ဘာကြောင့်
ဘာဖြစ်လို	ဘာဖြစ်လို့လဲ
ဘာ့	ဘာ
ဘားမှ	ဘာမှ
ဘာမှာလည်း	ဘာမှလည်း
ဘာလုပ် သင် ့တယ်	ဘာလုပ် သင့်တယ်
ဘအရေဇးပြီ	ဘာအရေးကြီးပြီ
ဘုရားကြိး	ဘုရားကြီး
ဘုရားပန်းထိုးေ နတဲ့ 	ဘုရားပန်းထိုးနေတဲ့ 
ဖျားဖျား	ဘုရား
ဘုရာ	ဘုရား
ဘော်လုံး	ဘောလုံး
ဘော့လုံးသမားဟောင်း	ဘောလုံးသမားဟောင်း
တရုတ်ဖက်	ဘက်
ဖက်	ဘက်
ဘင်္ဂလားဒေရှ့်	ဘင်္ဂလားဒေ့ရှ်
ဘင်္ဂ်လားဒေ့ရှ်	ဘင်္ဂလားဒေ့ရှ်
ဘတ်ဂျက်ရဲ ့	ဘတ်ဂျက်ရဲ့
ဘုန်းကြီ်းကျောင်း	ဘုန်းကြီးကျောင်း
ဘုနး်တန်ခိုး	ဘုန်းတန်ခိုး
ဘုနး်နိမ့်တယ်	ဘုန်းနိမ့်တယ်
ဘယ်ပြောက်နေမှန်းကိုမသိဘူး	ဘယ်ပျောက်နေမှန်းကိုမသိဘူး
ပယ်လို ပယ်လို	ဘယ်လို ဘယ်လို
ဘယ်လို့ 	ဘယ်လို
ဘိုလ်	ဘယ်လို
ဘိုလိုလုပ်ရပါ့	ဘယ်လိုလုပ်ရပါ့
ဘယ်သူလဲ	ဘယ်သူပဲ
ဘယ်ဒူ 	ဘယ်သူ
ဘူလိုက်မှာလဲ	ဘယ်သူလိုက်မှာလဲ
ဘသူ့	ဘယ်သူ့
ဘယ်ဟာဝယ်ရမလံ	ဘယ်ဟာဝယ်ရမလဲ
ဘယ်အချိန်ဖင့်ပြီး	ဘယ်အချိန်ဖွင့်ပြီး
ဘွဲ့ရလျင်	ဘွဲ့ရလျှင်
မတတပ်ဘူး	မကတတ်ဘူး
မကျ	မက
မကောင်းဖုးလို့	မကောင်းဘူးလို့
မကောင်းမှု့	မကောင်းမှု
မကျတေးဘူး	မကျသေးဘူး
မကြေနပ်မှု	မကျေနပ်မှု
မကြာခန	မကြာခဏ
မကြိုက်တည	မကြိုက်တာ
မကြိုဘူး	မကြိုက်ဘူး
မကြ်ုက်ဘူ	မကြိုက်ဘူး
မကြည် ့သင် ့ပါ	မကြည့်သင့်ပါ
မကြမ်းဖူး	မကြမ်းဘူး
မကွေ	မကွေး
မခေါ်ကြနက်နော်	မခေါ်ကြနဲ့နော်
မချစ်ပါဘူကွာ	မချစ်ပါဘူးကွာ
မငှဲ ့ဘဲ	မငှဲ့ဘဲ
မဆာမနာ	မစာမနာ
မစူးစိ်ုက်နိုင်တာမျိုး	မစူးစိုက်နိုင်တာမျိုး
မစည်းစား	မစဉ်းစား
မဆ်ို	မဆို
မဆိုးပါဖူး	မဆိုးပါဘူး
မဆောက်ပေးနိုုင်ဘူးတဲ့	မဆောက်ပေးနိုင်ဘူးတဲ့
မဆန်ပါ 	မဆန်းပါ 
မဆုံးဖြတ်ရသေးဘူးကြောင်း	မဆုံးဖြတ်ရသေးကြောင်း
မတူဘူးပေါ့့လေ	မတူဘူးပေါ့လေ
မတိုင်ခိုင်	မတိုင်ခင်
မတည်မညိမ်	မတည်မငြိမ်
မတတ််နိင်ဘူး	မတတ်နိင်ဘူး
မတိမ်းမရိမ်း	မတိမ်းမယိမ်း
မတွေ့ဖူးသေးပါ	မတွေ့ဘူးသေးပါ
တွေ့ရဘူး	မတွေ့ရဘူး
မထား ဖိုဆိုတာ	မထား ဖို့ဆိုတာ
မထွက်ပဲ	မထွက်ဘဲ
မထွက်ရတေးဘူး	မထွက်ရသေးဘူး
နက်ဖြန်	မနက်ဖြန်
မနက်ဖန်	မနက်ဖြန်
မနည်သတိထားနေတယ်	မနည်းသတိထားနေတယ်
မနှိူင်းယှဉ်ပါနဲ့	မနှိုင်းယှဉ်ပါနဲ့
မပါပါဖူး	မပါပါဘူး
မပျံနိ်ုင်	မပျံနိုင်
မပြုသင့်ဖူး	မပြုသင့်ဘူး
မပြည်လည်း	မပြေလည်
မပြောင်းပေးနိုင်သေး	မပြောင်းပေးနိုင်သေးဘူးလို့
မပြိုင်သင့်ဖူး	မပြိုင်သင့်ဘူး
မဖြစ်နို်ုင်ပါဘူးခင်ဗျာ	မဖြစ်နိုင်ပါဘူးခင်ဗျာ
မဖြစ်နိုက်ဘူး	မဖြစ်နိုင်ဘူး
မမီလို့	မမီလို့
မမေးခြင်တော့ပါဘူး	မမေးချင်တော့ပါဘူး
မမြင်ပါလာ	မမြင်ပါလား
မမြင်ဖူး	မမြင်ဘူး
မမြင်ရတေးဘူးလေ	မမြင်ရသေးဘူးလေ
မီနဲ့	မမှီနဲ့
မယူပဲနဲ	မယူပဲနဲ့
မရသာလည်း	မရတာလည်း
မရတော	မရတော့
မရဖူး	မရဘူး
မရသည် ့	မရသည့်
မရင့်ကြက်ကြသေးတာ	မရင့်ကျက်ကြသေးတာ
မ၇ပ်တည်ပါနဲ့	မရပ်တည်ပါနဲ့
မရပ်မနားဖြစ်နေေပသည့်	မရပ်မနားဖြစ်နေသည့်
မရွှေး	မရွေး
ရှိတော့ဘူး	မရှိတော့ဘူး
မရှ်ိပါဘူး	မရှိပါဘူး
မရှိပေမဲ့	မရှိပေမယ့်
မရှိဘဲ့	မရှိဘဲ
မရှိ်ရင် 	မရှိရင် 
မရှိသေးပေမဲ့	မရှိသေးပေမယ့်
မရှင်းပြသင့်ဖူး	မရှင်းပြသင့်ဘူး
မရွေပြောင်းနိုင်ခင်	မရွှေ့ပြောင်းနိုင်ခင်
မလိုလားလာ	မလိုလားတာ
လုပ်နက်	မလုပ်နက်
မလုပ်ရတေးဘူး	မလုပ်ရသေးဘူး
မလွတ်းတေးပါဘူး	မလွတ်သေးပါဘူး
မလွယ်တော့ပါဖူး	မလွယ်တော့ပါဘူး
မလွယ်ဘာ	မလွယ်ပါ
မလျော်သင့်ပေမယ့်	မလျှော်သင့်ပေမယ့်
အသိခဲ့ဘူး	မသိခဲ့ဘူး
မသ်ိတော့ဘူး	မသိတော့ဘူး
မသိဝူး	မသိဘူး
မသိရလိုက်	မသိလိုက်ရ
မသိသေးဘဲကိုယ်	မသိသေးဘဲကို
မသိသေးဘဲကိုယ်	မသိသေးဘဲကို
မသေချာပေမဲ့	မသေချာပေမယ့်
မသေခြာ	မသေချာ
မသဲကွဲဖူး	မသဲကွဲဘူး
မသည်းကွဲဘူးရယ်	မသဲကွဲဘူးရယ်
မသိင်္ဂ	မသိင်္ဂီထိုက်
မသတ်မှတ်ရဘူးလေး	မသတ်မှတ်ရဘူးလေ
မသွား နိ်ုင်ဘူး	မသွား နိုင်ဘူး
မသွားဘာဘူး	မသွားပါဘူး
မသွာအောင် 	မသွားအောင် 
မသွင်းခဲ့၇ဘူးပေါ့	မသွင်းခဲ့ရဘူးပေါ့
မဟာ	မဟာ
မဟောင်နိူင်တဲ့	မဟောင်နိုင်တဲ့
မဟုတာ	မဟုတ်တာ
မဟုတ်ပါပူး	မဟုတ်ပါဘူး
မဟုတ်ဖူး	မဟုတ်ဘူး
မဟုတ်ဘူ	မဟုတ်ဘူး
မဟုတ်ဘူူး	မဟုတ်ဘူး
မဟုပ်ဘူး	မဟုတ်ဘူး
မဟုတ်ဖူးလား	မဟုတ်ဘူးလား
မဟုတ်ပဲ	မဟုတ်ဘဲ
မပာုတ်၇င်	မဟုတ်ရင်
မဟုတလား	မဟုတ်လား
မာဘတ်စ	မာဘတ်စ်
မိည	မိဘ
မ📞📞မိ	📞📞မိမိ
မိသားစုဂသူငယ်ချင်းတွေနဲ့	မိသားစုသူငယ်ချင်းတွေနဲ့
မီဒီလာ	မီဒီယာ
မီးကြီုး	မီးကြီး
မီးပျက်တုံး	မီးပျက်တုန်း
မီးမှောင်းထိုးထားပါတယ်	မီးမောင်းထိုးထားပါတယ်
မိရထားလမ်းဆောက်လုပ်ရေး	မီးရထားလမ်းဆောက်လုပ်ရေး
မီးရိူ့	မီးရှို့
မီးရှိုးမှု	မီးရှို့မှု
မူခင်း	မူခင်း
မူးပီး	မူးပြီး
မူယစ်ဆေးဝါး	မူးယစ်ဆေးဝါး
မေမေ့	မေမေ
မေမေဆီ	မေမေ့ဆီ
မေလဆန်းပိ်ုင်း	မေလဆန်းပိုင်း
မေ့သွားလိမ့်မေတဲ့ 	မေ့သွားလိမ့်မယ်တဲ့ 
မောဟလည်းမကြီးချင်ပု	မောဟလည်းမကြီးချင်ဘူး
မောဒယ်	မော်ဒယ်
မော်ဒန်	မော်ဒယ်
မိုဘု်ိင်း	မိုဘိုင်း
မို ့	မို့
မို ့ 	မို့
မိ်ုးကျပြီးမှ	မိုးကျပြီးမှ
မိုးလေဝသစောငြ့်ကည့်ရေး	မိုးလေဝသစောင့်ကြည့်ရေး
မိုးလေဝဿ	မိုးလေဝသ
မက်စေ့	မက်စေ့ချ်
မက်ဆေ့ချ	မက်ဆေ့ချ်
မင်ကြီး	မင်းကြီး
မင် း ခေါင် းပါ	မင်း ခေါင်းပါ
မင် း	မင်း
မင်းအောင်လှိ်ုင်	မင်းအောင်လှိုင်
မောင်တောမြိ့ 	မောင်တောမြို့
မောင်တော	မောင်းတော
မောင်း၇န်	မောင်းရန်
မိုင်ပေါက်ကွဲမှု	မိုင်းပေါက်ကွဲမှု
မစ်္စ	မစ္စစ်
မစ္စ်	မစ္စစ်
မတ်စောင့်	မတ်ဆောက်
မေတ္တ	မေတ္တာ
မန်းလေးက	မန်းလေး
မိန်ြ့ကားခဲ့ပါတယ်	မိန့်ကြားခဲ့ပါတယ်
မိန့်ခွနး	မိန့်ခွန်း
မိန့် ့ခွန်း	မိန့်ခွန်း
မိန်ခခေ	မိန်းကလေး
မိန်းခလေး	မိန်းကလေး
မိန်းမဖြစ်၇တာဟာ	မိန်းမဖြစ်ရတာဟာ
မိနိးမ	မိန်းမ
မိ်န်းမ	မိန်းမ
မိန်မသာချင်း	မိန်းမသားချင်း
မိနး်မအဖြစ် 	မိန်းမအဖြစ် 
မုန်းတိုင်း	မုန်တိုင်း
မုန်	မုန့်တီ
မုန် ့	မုန့်
န်းပွါးစေတဲ့	မုန်းပွားစေတဲ့
မယ်သိီတာ	မယ်သီတာ
မဲ့	မယ့်
များပေမဟ့်	များပေမယ့်
မျ	များ
များလာခြင် း	များလာခြင်း
မျာလား	များလား
မျိူးဆက်	မျိုးဆက်
မျိူးဆက်သစ်	မျိုးဆက်သစ်
မျိုုး	မျိုး
မျက်စီ	မျက်စိ
မျက်နာ	မျက်နှာ
မျက်နှာရနိုင်မဲ့	မျက်နှာရနိုင်မယ့်
မျက်မှောက်ပြုလွယ်နိူင်	မျက်မှောက်ပြုလွယ်နိုင်
မျက်ရညိ	မျက်ရည်
မျောက်ပြဆန်တောင်	မျောက်ပြဆန်တောင်း
မြေတောင်မြောက်ပေး	မြေတောင်မြှောက်ပေး
မြိူ့နယ်	မြို့နယ်
မြိုနယ်	မြို့နယ်
မြို ့နယ်	မြို့နယ်
မြိ့	မြို့
မြိ ု့ 	မြို့
မြီု့	မြို့
မြို	မြို့
မြို ့	မြို့
မြို ့ 	မြို့
မြေက်ကိုးရီးယား	မြောက်ကိုရီးယား
မြောက်ကိုးရီးယား	မြောက်ကိုရီးယား
မြောက်ပိ်ုငး	မြောက်ပိုင်း
မြောက်ပိ်ုင်း	မြောက်ပိုင်း
မြောက်ပိုုင်း	မြောက်ပိုင်း
မြင်ခြင်တယ်	မြင်ချင်တယ်
မြင်တဲ့	မြင်တဲ့
မြင်တက်လာကြရင်	မြင်တတ်လာကြရင်
မြင်တွေ့နေကျ	မြင်တွေ့နေကြ
မြင်တွေ့ ့	မြင်တွေ့ 
မြင်ဖူးသွားပီ	မြင်ဖူးသွားပြီ
မြင်အိပါတယ်	မြင်မိပါတယ်
မြှင့်တက်နေပြီး	မြင့်တက်နေပြီး
မြစ်စုံ	မြစ်ဆုံ
မြတ်နိုူးနိူင်မယ့်	မြတ်နိုးနိုင်မယ့်
မြန်မာဒေတ	မြန်မာဒေသ
မြန်နိုင်ငံ	မြန်မာနိုင်ငံ
မြန်မာနိ်ုင်ငံ	မြန်မာနိုင်ငံ
မြန်မာနိူင်ငံ 	မြန်မာနိုင်ငံ 
မြန်မာနိူင်ငံ	မြန်မာနိုင်ငံ
မြန်မာ့နိူင်ငံ	မြန်မာနိုင်ငံ
မြန်မာနိ်ုင်ငံသား	မြန်မာနိုင်ငံသား
မြနာ်မပြည်	မြန်မာပြည်
မြန်မာပြည်း	မြန်မာပြည်
မြန်မှာပြည်	မြန်မာပြည်
မွေးလာကစ	မွေးလာကာစ
မ	မှ
မှတော့	မှာတော့
မဟာ	မှာ
မာ	မှာ
မျာ	မှာ
မှ	မှာ
မီ	မှီ
မှတ်ပုံထားပြီးဖြစ်ပါတယ်	မှတ်ပုံတင်ထားပြီးဖြစ်ပါတယ်
မှန်တရ်	မှန်တယ်
မှန်ပေမဲ့	မှန်ပေမယ့်
မ	မျှဝေကြ
မ ျှဝေခဲ့ပါတယ်	မျှဝေခဲ့ပါတယ်
မျှဝေရင် း 	မျှဝေရင်း 
မေ	မျှော်လင့်ချက်
မြင့်တင်ပေးဖို့	မြှင့်တင်ပေးဖို့
မွှေ ့ရာလေး	မွှေ့ရာလေး
ယခုကဲ့သို	ယခုကဲ့သို့
ကနေ့	ယနေ့
ယ၊ိ	ယိ
ယုဆပါတယ်	ယူဆပါတယ်
ယူထားခဲ့ကြေ င်း 	ယူထားခဲ့ကြောင်း
ယူနိုငမယ်	ယူနိုင်မယ်
ယူနိူင်	ယူနိုင်
ယူသင် ့တယ်	ယူသင့်တယ်
ယူသွါးမယ်လို့	ယူသွားမယ်လို့
၂	၂ယောက်
ယောကျာ်းတွေ	ယောက်ျားတွေ
ယောကျာ်းများ 	ယောက်ျားများ 
ယောကျာ်း	ယောက်ျား
ယော့ကျာ်း	ယောက်ျား
ယောက်ကျား	ယောက်ျား
ယောင်္ကျား	ယောက်ျား
ယွကျား	ယောက်ျား
ယောက်ျားရေ	ယောက်ျားရေ
ယောကျာ်းလေးများ	ယောက်ျားလေးများ
ယောကျာ်းလေး	ယောက်ျားလေး
ယောက်ကျားလေး	ယောက်ျားလေး
ယောက်ကျားသား	ယောက်ျားသား
၅ရောက်	၅ယောက်
ယောက်ျားတွေပါဟယ်လ်	ယောက်ျားတွေပါဟယ်
ယဉ်ကျေးမု	ယဉ်ကျေးမှု
ယဉ်ကျေးမှုငး	ယဉ်ကျေးမှု
ယဉ်ဂျေးမှု	ယဉ်ကျေးမှု
ယဉ် 	ယာဉ် 
ယဉ်	ယာဉ်
ယုံကြည်မူ	ယုံကြည်မှု
ယူံစားလာခဲ့တယ်	ယုံစားလာခဲ့တယ်
ယှာဉ်ကြည့်မှာ	ယှဉ်ကြည့်မှာ
ယှာဉ်ကြည့်ရင်	ယှဉ်ကြည့်ရင်
ယှဉ်ပြီး် 	ယှဉ်ပြီး
ရ	၇
ရခိုင့်ညွ ွန့်ဖူး	ရခိုင့်ညွန့်ဖူး
ရတနာပုုံ	ရတနာပုံ
ရတောဘမယ်	ရတော့မယ်
ရထားတန် 	ရထားတန်း
ရမလာ း	ရမလား
ရရှိလာသည် ့ 	ရရှိလာသည့်
ရလို	ရလို့
ရလာဒ်	ရလဒ်
ရလာဘ်	ရလဒ်
ရသွားပြီး	ရသွားပြီ
ရဉီးမှာပါ	ရဦးမှာပါ
ရအော်	ရအောင်
၇အောင်	ရအောင်
ရာခိုင်နှုုန်းက	ရာခိုင်နှုန်းက
ရာခိုင်နှူန်း	ရာခိုင်နှုန်း
ရာသိသွေး	ရာသီသွေး
ရီခြင်စရာတော့	ရီချင်စရာတော့
ရုက်ရှား	ရုရှား
ရေခဲသေတ္တ	ရေခဲသေတ္တာ
တွေ	ရေတွေ
ရေထိသ ွားတယ်	ရေထိသွားတယ်
ရေနစ်မြှုပ်	ရေနစ်မြုပ်
 ေ၇ပုန်း	ရေပုန်း
ေ ရဗူး	ရေဗူး
ရေရှားပါးတြ့	ရေရှားပါးတဲ့
 ေ၇ာ လျော်သတဲ့	ရေလျှော်သတဲ့
ရေလွှမ်းမိုးမှုလို့	ရေလွှမ်းမိုးလို့
ရေဝမ်တယ်	ရေဝပ်တယ်
ရေအားလျပ်စစ်မ	ရေအားလျှပ်စစ်
ရေးတော့မေ	ရေးတော့မယ်
ရေးထညးတာ	ရေးထားတာ
ရေးနိုင်ဖို	ရေးနိုင်ဖို့
ရေးနိုငျ်အာင်	ရေးနိုင်အောင်
ရဲ ဖော်တွေ	ရဲဘော်တွေ
ရဲမေ်တော်ယာဉ်	ရဲမော်တော်ယာဉ်
ရဲ	ရဲ့
ရဲ ့	ရဲ့
ရဲ ့ 	ရဲ့
၇ဲ့	ရဲ့
ကော	ရော
ရော်ဘာကျည်ဆန်နဲ့ပြစ်	ရော်ဘာကျည်ဆန်နဲ့ပစ်
ရကိ္ခုင့်	ရက္ခိုင့်
ရ ရက်	၇ ရက်
ရက်ရောကျတာမျိုး	ရက်ရောကြတာမျိုး
ရောက်တော့မရ် 	ရောက်တော့မယ်
ရောက်တုုံး	ရောက်တုန်း
ရောက်ဖိ်ု့	ရောက်ဖို့
ရောက်၇ှိနေပြီ	ရောက်ရှိနေပြီ
ရောက်အောင်သွားဖို	ရောက်အောင်သွားဖို့
ရင်ဆိုင်းရ	ရင်ဆိုင်ရ
ရင်ဆို	ရင်ဆိုင်
ရင့်ကြတ်မှု	ရင့်ကျက်မှု
ရင့်ကြတ်	ရင့်ကျက်
ရင့်ကြက်သူ	ရင့်ကျက်သူ
ရင် းနှီးပြီး	ရင်းနှီးပြီး
ရင်းနှီးမြှုပ်နှံမှီု	ရင်းနှီးမြှုပ်နှံမှု
ရင် းနှီး	ရင်းနှီး
ယင်း	ရင်း
ရောင်းချႏ နိုင်ဖွယ်ရှိတယ်	ရောင်းချႏ နိုင်ဖွယ်ရှိတယ်
ရောင် းပေးခြင် း	ရောင်းပေးခြင်း
ရိုင်းစိုက်ကြမ်းကြုပ်	ရိုင်းစိုင်းကြမ်းကြုတ်
ရည် မှန် းချက် 	ရည် မှန်းချက် 
ရည် မှန် းချက်	ရည် မှန်းချက်
ရည် မှန် းထားပါ	ရည် မှန်းထားပါ
ရုပ်တရပ်	ရုတ်တရက်
ရန်ကုန်တိ်ုင်း	ရန်ကုန်တိုင်း
ရန်ကုန်မြို	ရန်ကုန်မြို့ကြီး
ရန်ကုန်မြို	ရန်ကုန်မြို့
ရန်ကုန်မာတုန်းက	ရန်ကုန်မှာတုန်းက
ရပ်ကြပါတော	ရပ်ကြပါတော့
ရပ်တည်ပေးနိူင်	ရပ်တည်ပေးနိုင်
ရပ်ပါ	ရပ်ပ်ပါ
ရယ်မောပျော်ရွှင်နိူင်ကြပါစေ	ရယ်မောပျော်ရွှင်နိုင်ကြပါစေ
ရီမော	ရယ်မော
ရွာသွား	ရွာသား
၍့	၍
ရွေးကောက်	ရွေးကောက်ပွဲ
ရွေးချယ်နိုင်ဖိုပ	ရွေးချယ်နိုင်ဖို့
ရွေးခြယ်	ရွေးချယ်
ရွေးချယ်လိ်ု့မရဘူး	ရွေးချယ်လို့မရဘူး
ရွက်ဆောင်နိူင်ပါစေ	ရွက်ဆောင်နိုင်ပါစေ
ရှာနိုင် သည် ့	ရှာနိုင် သည့်
ရှိကျပါတယ်	ရှိကြပါတယ်
ရှိခဲ့လျင်	ရှိခဲ့လျှင်
ချိတော့ပု	ရှိတော့ဘူး
၇ှိတယ်	ရှိတယ်
ရှိနေတ့	ရှိနေတဲ့
ရှီနေပါတယ်	ရှိနေပါတယ်
ရှိနေပါလျှက်	ရှိနေပါလျက်
ရှိနေေသာ်လည်း	ရှိနေသော်လည်း
ရှိပါတဟ်	ရှိပါတယ်
ရှိပေမဲ့	ရှိပေမယ့်
ရှိ်ဖို့	ရှိဖို့
ရှိ်	ရှိ
ရှိသည် ့အတွက်	ရှိသည့်အတွက်
ရှု ့ခင်း	ရှုခင်း
ရှုထောင်း	ရှုထောင့်
ရှ ုဒေါင့်စုံက	ရှုဒေါင့်စုံက
ရူ့ဒောင့်	ရှုဒေါင့်
ရူ့ဒေါင့်	ရှုဒေါင့်
ရှုမင်ကြပါတယ်ရှင်	ရှုမြင်ကြပါတယ်ရှင်
ရူနေရပါတယ့်	ရှူနေရပါတယ်
ရှိုးဖိနပ်	ရှူးဖိနပ်
ရှေ ့နေ	ရှေ့နေ
ရှေ	ရှေ့မှာ
ရှေ ့	ရှေ့
ရှင်စောပူ	ရှင်စောပု
ရှင်း ပြစ်ပြီး	ရှင်း ပစ်ပြီး
ရှင် းလင် းပြောကြားရမည် ့	ရှင်းလင်းပြောကြားရမည့်
ရှင် းလင် းပြောပြသည်	ရှင်းလင်းပြောပြသည်
ရှင် းလင် း	ရှင်းလင်း
၇ှင်	ရှင်
ရှုတ်ချကြောင်း၊	ရှုံ့ချကြောင်း၊
ရှုတ်ချ	ရှုံ့ချ
ရှူံးခဲ့တဲ့	ရှုံးခဲ့တဲ့
ရှူံးတာလား	ရှုံးတာလား
ရှယ်ယားဈေး	ရှယ်ယာဈေး
 ေ့ရွှဆိုင်းတာ	ရွှေ့ဆိုင်းတာ
ရွေ့ ့ပြီး	ရွှေ့ပြီး
ရွေပြောင်းမူ	ရွှေ့ပြောင်းမူ
ရွေပြောင်း	ရွှေ့ပြောင်း
ရွှေ ့ပြောင်း	ရွှေ့ပြောင်း
ရွှေ ့	ရွှေ့
ရွေ့လိုက်တယ်	ရွှေ့လိုက်တယ်
လစား	လစာ
လဆန်းပိ်ုင်း	လဆန်းပိုင်း
လစမ်း	လဆန်း
လာပစလေ။	လာပါစေလေ။
လ	လာမယ့်
လာရောက်ကျပါရန်	လာရောက်ကြပါရန်
လာ	လာ
လလုပ်	လာလုပ်
လာအိ်ု	လာအို
လားရှိူး	လားရှိုး
ယူဂျီး	လူကြီး
လူးကြီး	လူကြီး
လူငယ်တေ ွ 	လူငယ်တွေ
လူယေ်တွေ	လူငယ်တွေ
လူယေ်လူရွယ်	လူငယ်လူရွယ်
လူဌား	လူငှား
လုတော်	လူတော်
လူတိ်ုင်း	လူတိုင်း
လူတစု	လူတစ်စု
လူတသိုက်ကြောင်	လူတစ်သိုက်ကြောင့်
လူတတ်ကြီးလုပ်ချငိကြတာကိုး	လူတတ်ကြီးလုပ်ချင်ကြတာကိုး
လူတွေကိ်ု	လူတွေကို
ယူထု	လူထု
လူပျိုကြိီး	လူပျိုကြီး
လူမျိုးတုန်း	လူမျိုးတုံး
လူမျိူး	လူမျိုး
လူမူ့ရေး	လူမှုရေး
လုူ	လူ
လူး	လူ
လူဥိးရေ	လူဦးရေ
လေကြောင်းလိ်ုင်း	လေကြောင်းလိုင်း
လေယာဉ်တင်း	လေယာဉ်တင်
လေယဉ်	လေယာဉ်
လေလံပြစ်ပွဲကြီး	လေလံပစ်ပွဲကြီး
လေ့လာခဲရ	လေ့လာခဲ့ရ
လေ့ လာမှု့ 	လေ့ လာမှု
ငလေးစားမိပါတယ်	လေးစားမိပါတယ်
လေးစားလျှက်	လေးစားလျက်
လောလောဆည်	လောလောဆယ်
လိူချင်တာ	လိုချင်တာ
ကြီးိုအပ်ပါတယ်	လိုအပ်ပါတယ်
လိ်ု့	လို့
လိို့ 	လို့
လု့	လို့
လို	လို့
လိုပ	လို့
လို ့	လို့
လို ့ 	လို့
လိုလည်း	လို့လည်း
လက်ခံပီး	လက်ခံပြီး
လက္ခံမယ်လို့	လက်ခံမယ်လို့
လက်တွေ	လက်တွေ့
လက်ထပ်	လက်ထက်
လက်နက်ကိ်ုင်တပ်	လက်နက်ကိုင်တပ်
လက်နက်ကိ်ုင်	လက်နက်ကိုင်
လဘက်ခြံ	လက်ဖက်ခြံ
လ္ဘက်သုပ်	လက်ဖက်သုပ်
လက်ဘွေ	လက်ဗွေ
လက်မခံနိူင်ခြင်း	လက်မခံနိုင်ခြင်း
လက်မူ	လက်မှု
လက်မှတိ	လက်မှတ်
လက်ရှိမှာတော	လက်ရှိမှာတော့
လက်ရှီ	လက်ရှိ
လက်သည်းဆိုးဆေးနံ ့	လက်သည်းဆိုးဆေးနံ့
လက်သည်းဆိ်ုးဆေးအနံ့	လက်သည်းဆိုးဆေးအနံ့
လာက်က	လောက်က
သောက်	လောက်
လိ်ုက်တက်ခွင့်ရမှာပါ	လိုက်တက်ခွင့်ရမှာပါ
လိုက်ထဲ့	လိုက်ထည့်
လိုက်နိ်ုင်ကြပါတယ်	လိုက်နိုင်ကြပါတယ်
လိုက်ဖက်နေတာ	လိုက်ဖတ်နေတာ
လိုက်ဖက်နေတုန်း	လိုက်ဖတ်နေတုန်း
လိ်ုက်လံ	လိုက်လံ
လိုက်လိုက်လဲလဲ	လိုက်လိုက်လှဲလှဲ
လိ်ုက်လျောချက်	လိုက်လျောချက်
လိုက်လော	လိုက်လျော
လိငင်းပိုင်းဆိုင်ရာ	လိင်ပိုင်းဆိုင်ရာ
လိုင်စဉ်	လိုင်စင်
လိ်ုင်ပေါ်မှာ	လိုင်းပေါ်မှာ
လည်ပါတ်	လည်ပတ်
တည်း	လည်း
လဲဘဲ	လည်းပဲ
လဲဘဲ 	လည်းပဲ
လည်းေ၇ကြီးမူ	လည်းရေကြီးမူ
လ	လည်း
လညး်	လည်း
လဲ	လည်း
လည် း 	လည်း 
လည် း	လည်း
၄	၎
လတ်တလာ	လတ်တလော
လတ်တလေ	လတ်တလော
လပ်	လပ်
လုပ်ကိ်ုင်	လုပ်ကိုင်
လုပ်ပခဲ့တဲ့	လုပ်ခဲ့တဲ့
လုပ်ငန်းှင်	လုပ်ငန်းရှင်
လုပ်ငနး်	လုပ်ငန်း
လုပ် ငန် း	လုပ် ငန်း
လုပ်ဆောင်တာကိုး 	လုပ်ဆောင်တာကို
လုပ်ဒါပါ	လုပ်တာပါ
လုပိနေတာ	လုပ်နေတာ
လုပ်နေသာလဲ	လုပ်နေတာလဲ
လုပ်နေတုံး	လုပ်နေတုန်း
လုပ်နိ်ုင်ကြတယ်	လုပ်နိုင်ကြတယ်
လုပ်နိ်ုင်ဖို့ပဲ	လုပ်နိုင်ဖို့ပဲ
လုပ် နိုင် မည် ့ 	လုပ် နိုင် မည့်
လုပ်နိူင်မှာ	လုပ်နိုင်မှာ
လုပ်ပေးနိူင်တဲ့	လုပ်ပေးနိုင်တဲ့
လုပ်ပြိးမှ	လုပ်ပြီးမှ
လုပ်ဖေါ်ကိုင်ဖက်	လုပ်ဖော်ကိုင်ဖက်
လုပ်ဖေါ်ကိုင်ဖက်	လုပ်ဖော်ကိုင်ဖက်
လုပ်ဖို	လုပ်ဖို့
လူပ်မပေးန်ုင်	လုပ်မပေးနိုင်
လုပ်ရပါလိ်မ့်မယ်	လုပ်ရပါလိမ့်မယ်
လုပ်သွားမဲ့	လုပ်သွားမယ့်
လဒ်စား	လာဘ်စား
လမ်းပျော်နေမှာ	လမ်းပျောက်နေမှာ
လမ်းဖေါက်လုပ်ရေး	လမ်းဖောက်လုပ်ရေး
လိ်မ့်မယ်၊	လိမ့်မယ်၊
လိ်မ့်မယ်	လိမ့်မယ်
လိမ်	လိမ့်မယ်
လိမ်မယ်	လိမ့်မယ်
လေုံခြုံရေး	လုံခြုံရေး
လုံးလစိုက်	လုံ့လစိုက်
လုံံ့လ 	လုံ့လ 
လုံးပ	လုံးဝ
လယ်မြေသိမ်းးခံရတာနဲ့	လယ်မြေသိမ်းခံရတာနဲ့
လျှာထားခံ	လျာထားခံ
လျှော်ကြေး	လျော်ကြေး
လျို့ဝှက်အက်	လျို့ဝှက်ချက်
လွှဲသွားတယ်	လွဲသွားတယ်
လွြတ်ငိမ်းခွင့်	လွတ်ငြိမ်းခွင့်
လွှတ်မြောက်ကျမှာပါ	လွတ်မြောက်ကြမှာပါ
လတွ်မြောက်ဖို့	လွတ်မြောက်ဖို့
လတွ်မြောက်မယ်	လွတ်မြောက်မယ်
ခွတ်မြောက်လာမယ်	လွတ်မြောက်လာမယ်
လွှတ်လပ်ရေး	လွတ်လပ်ရေး
လွတ်တလပ်	လွတ်လပ်
လွန်သွားပီ	လွန်သွားပြီ
လွယ်တာယ်	လွယ်တယ်
လှလှလေးဒေရမယ်	လှလှလေးတွေရမယ်
လှူဒါန်လိုသူများ	လှူဒါန်းလိုသူများ
လှုပေးဖို့	လှူပေးဖို့
လှိုင်မြို ့နယ်	လှိုင်မြို့နယ်
လိုင်သာယာ	လှိုင်သာယာ
လှည်လည်	လှည့်လည်
လှိုင်ခေါင်း	လှိုဏ်ခေါင်း
လုူပ်ရှားကြ	လှုပ်ရှားကြ
လှန်းအကြောင်းကြားမှပဲ	လှမ်းအကြောင်းကြားမှပဲ
လှုပ်ဆော်	လှုံ့ဆော်
လျော့ချတယ်	လျှော့ချတယ်
လျော့ချဖို့	လျှော့ချဖို့
လျှောက်တွက်လို့	လျှော့တွက်လို့
လျော့ပေးုပီး	လျှော့ပေးပြီး
လျော်ဖွတ်	လျှော်ဖွတ်
လျော်ရမယ် 	လျှော်ရမယ် 
လျော်ရမယ်	လျှော်ရမယ်
လှို့ဝှက်ချက်	လျှို့ဝှက်ချက်
လျှို ့ဝှက်ချက်	လျှို့ဝှက်ချက်
လျှိူ့ဝှက်တယ်	လျှို့ဝှက်တယ်
လျောက်ကြည့်တော့	လျှောက်ကြည့်တော့
လျောက်	လျှောက်
လျောက်လှမ်းနိူင်ပါစေ	လျှောက်လှမ်းနိုင်ပါစေ
လျပ်စစ်ဓါတ်အား	လျှပ်စစ်ဓါတ်အား
လျပ်စစ်	လျှပ်စစ်
လွဲချ	လွှဲချ
လွှတ်တာ်	လွှတ်တော်
လွှတ်အမတ်	လွှတ်တော်အမတ်
လွတ်ပေးခဲ့တာ	လွှတ်ပေးခဲ့တာ
လွတ်ပေးပါ	လွှတ်ပေးပါ
လွတ်လိုက်ပြီ	လွှတ်လိုက်ပြီ
၂ဝ၁၂ဝ	၂ဝ၂ဝ
၀ါဆို	ဝါဆို
၀ါတော် 	ဝါတော် 
၀ါရှင်တန်	ဝါရှင်တန်
ဝါသန်ပါခဲ့တော့	ဝါသနာပါခဲ့တော့
ဝါတနာ	ဝါသနာ
၀ါ	ဝါ
ဝရိယ	ဝီရိယ
၀ူးရှူး	ဝူရှူး
 ဝေဌပေး့ပြီး	ဝေငှပေးပြီး
ဝေသနာ	ဝေဒနာ
၀ေဖန်	ဝေဖန်
ေးသလား	ဝေးသလား
ဝက်ဆိုင်	ဝက်ဘ်ဆိုက်
ဝင်ကြ၇တယ်	ဝင်ကြရတယ်
ဝင်ကျိသွား	ဝင်ကြည့်သွား
ဝင် ငွေနည် းနေပေမဲ့	ဝင် ငွေနည်းနေပေမဲ့
စဝင်းထက်စိုး	ဝင်းထက်စိုး
ဝိုင်ကူညီကြဖို့ 	ဝိုင်းကူညီကြဖို့ 
ဝံဂျီးဂျုတ် 	ဝန်ကြီးချုပ်
ဝန်ကြိး	ဝန်ကြီး
ဝန်းကြီး	ဝန်ကြီး
ဝန်ထမ်းတေ ွဟာ	ဝန်ထမ်းတွေဟာ
ဝန် းကျင်	ဝန်းကျင်
ဝပ်ရှော့လး	ဝပ်ရှော့လေး
ဝမ်းနဲဖွယ်	ဝမ်းနည်းဖွယ်
ဝမ်းနည်းလားပီ	ဝမ်းနည်းလားပြီ
ဝမ်းနဲ	ဝမ်းနည်း
ဝယ်ခဲ့ ေ ပးေ သာအခါ....	ဝယ်ခဲ့ပေးသောအခါ....
ဝယ်မေတယိ	ဝယ်နေတယ်
ဝယ်ေ ပးပီး	ဝယ်ပေးပြီး
ဝယ်ပီးသွားပီး	ဝယ်ပြီးသွားပြီး
ဝယ်လိုက်မိ်တယ်	ဝယ်လိုက်မိတယ်
သတိယ	သတိရ
သတင်းထောက်တိ်ုင်း	သတင်းထောက်တိုင်း
သတင်းထောက	သတင်းထောက်
တနားစရာ	သနားစရာ
သပိတ်မှောက်ဆို့ 	သပိတ်မှောက်စို့
သဘွယ်	သဖွယ်
သဘောတရားိကု	သဘောတရားကို
သဘောတူးချက်	သဘောတူချက်
သဘောတူး	သဘောတူ
သဘာပဲ	သဘောပဲ
သမိး	သမီး
သမဂ	သမဂ္ဂ
သရက်သီ	သရက်သီး
တရုတ်ဆောင်	သရုပ်ဆောင်
သိ်မယ်	သိမယ်
သိမြင်နိူင်စွမ်း	သိမြင်နိုင်စွမ်း
သိရမေ	သိရမယ်
သိလိုက်တရ်	သိလိုက်တယ်
သာတာပဲ	သိသာတာပဲ
သိသိသာသာကြိး	သိသိသာသာကြီး
သီချင် းခွေ 	သီချင်းခွေ 
သုံည	သုည
တူ	သူ
သို့တို့က	သူတို့က
သူတိို့ကို	သူတို့ကို
သူတု.ိကို	သူတို့ကို
သူ တို့ ိကို	သူ တို့ကို
သူတိုပဲ	သူတို့ပဲ
သူတို ့လဲ 	သူတို့လဲ 
သူတို့လဲ	သူတို့လည်း
သတို့	သူတို့
သူတိ်ု့	သူတို့
သူတို	သူတို့
သူ တို ့	သူ တို့
သူတို ့	သူတို့
ဗိသူတွေ	သူတွေ
သူတေ	သူတွေ
သရဲဘောကြောင်	သူရဲဘောကြောင်
သူလဲ	သူလည်း
သပ်လျှျိုရှိတဲ့အခါမှာ	သူလျှိုရှိတဲ့အခါမှာ
သ ူ	သူ
သူ့ကိ်ု	သူ့ကို
သူမှာ	သူ့မှာ
သူ ့ ရဲ ့	သူ့ရဲ့
သူ့	သူ့
သူ ့	သူ့
သွသူ	သူ့ဟာသူ
သူအနေနဲ့	သူ့အနေနဲ့
သူ့အလှညိ့	သူ့အလှည့်
သေခြာသလောက်	သေချာသလောက်
သေချ	သေချာ
သေချင်တောလား	သေစေချင်နေတာလား
သေဆုုံး ကုန်ရတယ်	သေဆုံး ကုန်ရတယ်
သနက်	သေနတ်
သေသေခြာခြာ	သေသေချာချာ
သေ၀ပ်သည်	သေ၀ပ်သည်
သေကြာ	သောကြာ
သံတမာန်	သံတမန်
သံတုတ်ကိ်ု	သံတုတ်ကို
သံယောဇ႕ဉ်	သံယောဇ႕ဉ်
သံလွင့်	သံလွင်
သံဿယ	သံသယ
သို ့မဟုတ် 	သို့မဟုတ် 
သို ့မဟုတ်	သို့မဟုတ်
သို့သော်လညး်	သို့သော်လည်း
သို ့	သို့
သက်ကြီးရွယ်အိ်ု	သက်ကြီးရွယ်အို
သက်ဆိုင်တယ့်	သက်ဆိုင်တဲ့
သက်ဆိ်ုင်ရာ	သက်ဆိုင်ရာ
သက်တန်းကုန်	သက်တမ်းကုန်
သက်နြ်တုန်းက	သက်နှင်းတုန်းက
သက်သက်ခိူင်	သက်သက်ခိုင်
သက်ဉီးဆံပိုင်	သက်ဦးဆံပိုင်
သိပ်ခါ	သိက္ခာ
သောက်စားချင်တိ်ုင်း	သောက်စားချင်တိုင်း
သောက်တလွဲံ	သောက်တလွဲ
သင်ကြားမဲ့	သင်ကြားမယ့်
တင်ခိုင်းစေချင်တယ်	သင်ခိုင်းစေချင်တယ်
သင်္ချာိ	သင်္ချာ
သင်တန်းသားတွေံ	သင်တန်းသားတွေ
သင်ဖြူ းဖျာကလေး	သင်ဖြူးဖျာကလေး
သင်မဲ့	သင်မယ့်
သင့်တော့	သင့်တော်
သင် ့	သင့်
သင် း	သင်း
သငိးသင်း	သင်းသင်း
 ၂သောင်	၂သောင်း
သောင် း	သောင်း
သည် ့	သည့်
သည့်ခံတယ်	သည်းခံတယ်
သည့်ခံနိူင်တဲ့	သည်းခံနိုင်တဲ့
သီးခံပေးပါဦး	သည်းခံပေးပါဦး
သည့်မခံနိူင်တဲ့	သည်းမခံနိုင်တဲ့
သက်မှတ်	သတ်မှတ်
သုက်ပိုးကိုမှု	သုတ်ပိုးကို
သုတ်သုင်	သုတ်သင်
သန့်၇ှင်းမှု	သန့်ရှင်းမှု
သန် ့ရှင်းရမယ် 	သန့်ရှင်းရမယ် 
သန် းပေါင် းများစွာ	သန်းပေါင်းများစွာ
သိန်းတထောင်ကျော်	သိန်းတစ်ထောင်ကျော်
သနိ်းတစ်ထောင်	သိန်းတစ်ထောင်
သိန် း	သိန်း
သိန် း 	သိန်း
သိ်ပ်ကို 	သိပ်ကို 
သိတ်ဂရုမစိုက်ကြလို့	သိပ်ဂရုမစိုက်ကြလို့
သိပံ္ပနည်းကျ 	သိပ္ပံနည်းကျ 
သိပ်မှားတါ	သိပ်မှားတာ
ိသိပ်	သိပ်
သမတ 	သမ္မတ 
သိမ်းဌက်	သိမ်းငှက်
သီမ်းဆည်းခဲ့ ပြီး 	သိမ်းဆည်းခဲ့ ပြီး 
သိ်မ်းယူဖို့ 	သိမ်းယူဖို့ 
သုံးစဲပွါ	သုံးစွဲပါ
သုံနှစ်	သုံးနှစ်
သှုံနှစ်	သုံးနှစ်
သုံးနှုံး	သုံးနှုန်း
သုံးလို့တို့	သုံးလို့တော့
သည်ဆောင်ထားပါတယ်	သယ်ဆောင်ထားပါတယ်
သြစတေးလျှ	သြစတေးလျ
သွားတောမယ်တဲ့	သွားတော့မယ်တဲ့
သာံးတွေ့	သွားတွေ့
သွားထိ်ုင်	သွားထိုင်
သွာူပါတယ်	သွားပါတယ်
သွားဖို	သွားဖို့
သွားဲရကြောင်း	သွားရဲကြောင်း
သွေဖည်နိုင်	သွေဖယ်နိုင်
သွေဖည်	သွေဖယ်
သွေးကြောကျဥ်း	သွေးကြောကျဉ်း
သွငး်ကုန်	သွင်းကုန်
သွန်းကုန်	သွင်းကုန်
သွယ်တန်းပေးနိူင်ဆဲ	သွယ်တန်းပေးနိုင်ဆဲ
ဟဲ ့	ဟဲ့
ဟောပြောနေစဉ့်	ဟောပြောနေစဉ်
ဟော်တယ်	ဟိုတယ်
ဟိုဖက်ဒိဖက်	ဟိုဖက်ဒီဖက်
ဟိုရွေ ့ဒီရွေ့	ဟိုရွှေ့ဒီရွှေ့
ဟု	ဟို
ဟိုးရင်က	ဟိုးအရင်က
ဟးဟး	ဟင်းဟင်း
ဟုကဲပါ 	ဟုတ်ကဲ့ပါ
ဟုတ္ကဲ့	ဟုတ်ကဲ့
ဝုဒယ်	ဟုတ်တယ်
ဟုတ်သယ်	ဟုတ်တယ်
ဟုတ်နေခဲ့တာဘဲ	ဟုတ်နေခဲ့တာပဲ
ဟုပါတယ်	ဟုတ်ပါတယ်
ဟတ်စ်	ဟတ်စ်
အကူညီတောင်ခံတာပါ	အကူညီတောင်းခံတာပါ
အကူအညီတောင်မလား	အကူအညီတောင်းမလား
အယ်ကို	အကို
အကောင်အထည် ဖေါ်နေတဲ့ 	အကောင်အထည် ဖော်နေတဲ့ 
အကောင်အထည် ဖောက်နိုင်ဖို့	အကောင်အထည် ဖော်နိုင်ဖို့
အကောင်းဆုံးဖစ်အောင်	အကောင်းဆုံးဖြစ်အောင်
အကုန်ရပီမလားတယ့်	အကုန်ရပီမလားတဲ့
အကျိူးကျေးဇူး	အကျိုးကျေးဇူး
အကျိုးစီးပွါး	အကျိုးစီးပွား
အကျိုူးပေးမှာပါ	အကျိုးပေးမှာပါ
အကျီူးပြုနေလို့ပါ	အကျိုးပြုနေလို့ပါ
အကျိုးရလာဒ်	အကျိုးရလဒ်
အက	အကျိုးရှိပါတယ်
အကျင်း 	အကျင့်
အကြပ်အတည်း	အကျပ်အတည်း
အကျယ်တဝန့်	အကျယ်တဝင့်
အကြိးအကျယ်	အကြီးအကျယ်
အကြံအ	အကြံဉာဏ်
အကြံအဉာဏ်	အကြံဉာဏ်
အကြုိက်ဆုံး	အကြိုက်ဆုံး
အကြောင် းတွေပဲ 	အကြောင်းတွေပဲ 
အကြောငး်ပြ	အကြောင်းပြ
အကြောငး်မျိုးမျိုး	အကြောင်းမျိုးမျိုး
အကြောင် း 	အကြောင်း 
အကြောင် း	အကြောင်း
အောကာင်း	အကြောင်း
အကျိ 	အကြည့်
အကြည့့်	အကြည့်
အကျိတ်အနယ်	အကြိတ်အနယ်
အကျပ်ရိုက်	အကြပ်ရိုက်
အကြမ်းဘက်သမား	အကြမ်းဖက်သမား
အကြမ်းဘက်	အကြမ်းဖက်
ပကြမ်းဖျင်း	အကြမ်းဖျင်း
အကွက်မရွေ့ ့မှီ 	အကွက်မရွှေ့မှီ 
အခတော့	အခုတော့
ခုလို	အခုလို
အခလို	အခုလို
အခုပ	အခု
အခိ်ုင်အမာ	အခိုင်အမာ
အခိ်ုင်းအစေ	အခိုင်းအစေ
အခန် း	အခန်း
အခန်းအနား	အခမ်းအနား
အချိ	အချို့
အချို	အချို့
အချုစ်	အချုစ်
အချိနါကုန်သွားတယ်	အချိန်ကုန်သွားတယ်
ချိန်တန်ရင်	အချိန်တန်ရင်
အချိန်မဟာ	အချိန်မှာ
ချုပ်အခြာအာဏာ	အချုပ်အခြာအာဏာ
အခြေနေ	အခြေအနေ
အခြေပနေ	အခြေအနေ
အခွငေ့်၇း	အခွင့်အရေး
အခွင် ့အရေး	အခွင့်အရေး
အငြိုတေးထားခြင်း	အငြိုးတေးထားခြင်း
အငြင်းပွါးမှု	အငြင်းပွားမှု
အညင်းပွါးမှု	အငြင်းပွားမှု
အညှင်းပွါး	အငြင်းပွား
အဌားသုံးဖို့ဘဲ	အငှားသုံးဖို့ပဲ
အစပိုင် း 	အစပိုင်း 
အစား ့ 	အစား 
အစိအစဉ်	အစီအစဉ်
အစိုးရရက	အစိုးရက
အစိုးရတုံးက	အစိုးရတုန်းက
အစိုးရပ်	အစိုးရ
အစမ်ပ	အစမ်း
အစွဲအလမ်းကြီးပီး	အစွဲအလမ်းကြီးပြီး
အဆက်သွယ်မရှိတဲ့တဲ့သူ	အဆက်သွယ်မရှိတဲ့သူ
အဆောက်အဉီ	အဆောက်အဦး
အဆောက်အဦီး	အဆောက်အဦး
အဆင်ပြေပေမဲ့ 	အဆင်ပြေပေမယ့်
အဆင်ပြ	အဆင်ပြေ
အဆင်မပြေမှု့	အဆင်မပြေမှု
အဆင်မပြေမှူ	အဆင်မပြေမှု
အဆင်သင့် ဖစ်ပြီလား	အဆင်သင့် ဖြစ်ပြီလား
အဆင့်အတန်းသိအောင်လုပ်ပြစ်လိုက်	အဆင့်အတန်းသိအောင်လုပ်ပစ်လိုက်
အဆိပ်ဓါတ်ငွေ့	အဆိပ်ဓာတ်ငွေ့
အဆုံးမတော့ 	အဆုံးမတော့ 
အတူူတူ	အတူတူ
အတော်များများကြ	အတော်များများက
အတာ် လေးကောင် းပါတယ် 	အတော် လေးကောင်းပါတယ် 
အတော် အသင် ့ 	အတော် အသင့်
အတို	အတိုး
အတိ်ုင်ပင်ခံ	အတိုင်ပင်ခံ
အတိုင်သာ	အတိုင်းသာ
အတည်ပြုနိ်ုင်တဲ့	အတည်ပြုနိုင်တဲ့
အတည်ပြုဖို	အတည်ပြုဖို့
အတတ်နိူင်ဆုံး	အတတ်နိုင်ဆုံး
အတက်ပညာ	အတတ်ပညာ
အတိ်တ်	အတိတ်
အတန်ပညာ	အတန်းပညာ
အတေ့်အကြုံ	အတွေ့အကြုံ
အတွေ့ အကြံ ု 	အတွေ့ အကြုံ
အတကွ်က	အတွက်က
အတကွ်ဘဲ 	အတွက်ပဲ
အတကွ် 	အတွက်
အတွက	အတွက်
အတ ွက် 	အတွက် 
အတွက် ်	အတွက်
အတွဉ်	အတွက်
အသဝက်	အတွက်
အတွင် းထဲ	အတွင်းထဲ
အထူးဘဲ	အထူးပဲ
အထုူး	အထူး
အထဲမှာကိုဘဲ	အထဲမှာကိုပဲ
အထောက်အပှံ့	အထောက်အပံ့
အထုတ်	အထုပ်
အထွာ	အထွာ
အဓိကတော့	အဓိကကတော့
အဓိကမကြပါ	အဓိကမကျပါ
အဓမ ္မ	အဓမ္မ
အဓမ္မ ္မ	အဓမ္မ
အနာဂါတ်	အနာဂတ်
အနားမယူမိခဲဲ့ရင် 	အနားမယူမိခဲ့ရင် 
အနားယူလိုက်ပါအုံးမယ်	အနားယူလိုက်ပါဦးမယ်
အနီးတဝှိက် 	အနီးတဝိုက်
အနီအနား	အနီးအနား
အနာပညယ	အနုပညာ
အနှပညာ	အနုပညာ
အနုအညွှန့် 	အနုအညွန့်
အနနဲ့တော့	အနေနဲ့တော့
အနေနဲ.သာ	အနေနဲ့သာ
အနေနဲ	အနေနဲ့
အနံ ့	အနံ့
အနံ ့အသက်	အနံ့အသက်
အနပ်	အနက်
အနိူင်ယူမယ့်	အနိုင်ယူမယ့်
အနဲငယ်	အနည်းငယ်
အနည် းငယ်	အနည်းငယ်
အနည်းယေ်	အနည်းငယ်
အနဲအကျဉ်း	အနည်းအကျဉ်း
ဘအနိမ့်ဆုံး	အနိမ့်ဆုံး
အနှောက်အယှက်	အနှောင့်အယှက်
အနှောက်အယှက်	အနှောင့်အယှက်
အနစ်သာရ	အနှစ်သာရ
အပါအယင်	အပါအဝင်
အပုူတပြင်း	အပူတပြင်း
အေပါ်မှာ	အပေါ်မှာ
အပေါ	အပေါ်
အပိူတယောနဲရှပ်တယ်	အပိုတစ်ယောက်နဲ့ရှုပ်တယ်
အပိုင် း	အပိုင်း
အပစ်အခက်	အပစ်အခတ်
အပျာ်အပါးတွေ	အပျော်အပါးတွေ
အပျတ်	အပျက်
အပျင်းပြေလာ	အပျင်းပြေလား
အပြေားအဆို	အပြောအဆို
အပြောင်အလဲ	အပြောင်းအလဲ
အပစ်တင်	အပြစ်တင်
အပြစ်ပ်	အပြစ်ပါ
မပစ်မတင်တက်ပါ	အပြစ်မတင်တတ်ပါ
အပစ်မဲ့	အပြစ်မဲ့
အပစ်မြင်ပါတော့တယ်	အပြစ်မြင်ပါတော့တယ်
အပစ်	အပြစ်
အပြည့်ပ	အပြည့်ပဲ
အဖီးကျိူးများ	အဖီးကျီးများ
အဖိုးတန်း	အဖိုးတန်
အဖြေရှာပေးလိမ် ့မည် 	အဖြေရှာပေးလိမ့်မည် 
အဖြစ်ဆိူး	အဖြစ်ဆိုး
အဖွဲ့ငယ်ပေါင်းး	အဖွဲ့ငယ်ပေါင်း
အဖွဲ ့ ဝင် 	အဖွဲ့ဝင် 
အဖွဲ ့ဝင်	အဖွဲ့ဝင်
အဖွဲ ့အစည်းများ	အဖွဲ့အစည်းများ
အဖွဲ ့	အဖွဲ့
အမ်မလေး	အမလေး
အမောငိ	အမောင်
အမိန် ့နဲ ့ 	အမိန့်နဲ့
အံမရ်	အမယ်
အများကြိး	အများကြီး
အများစကု	အများစုက
များစု	အများစု
အမျိိုးကု	အမျိုးကု
အမျိူ းမျူ ိး	အမျိုးမျိုး
အမျိုးသဦးကို	အမျိုးသမီးတစ်ဦးကို
အမျို	အမျိုးသမီးများ
အမျိူးသမီး	အမျိုးသမီး
အမျီုူသမီး	အမျိုးသမီး
အမျိုုးသမီး	အမျိုးသမီး
အမျိ ုးသား	အမျိုးသား
အမျိူးသား	အမျိုးသား
အမျိူး	အမျိုး
အမှာအမှန်	အမှားအမှန်
အမှူစစ်	အမှုစစ်
အမှုလိုက်ခဲတာ	အမှုလိုက်ခဲ့တာ
အမှူ	အမှု
အမိူက်ပုံ	အမှိုက်ပုံ
အမိူက်မီးရိူ့စက်	အမှိုက်မီးရှို့စက်
အမိူက်	အမှိုက်
အမှောင်ကြတဲ့ညပေါ့	အမှောင်ကျတဲ့ညပေါ့
အမှတ်တမဲ ့	အမှတ်တမဲ့
အမှတ် တေလည်း	အမှတ် တွေလည်း
အမှတ်၇တယ်	အမှတ်ရတယ်
အမှန်နရား	အမှန်တရား
အမှန်အတိ်ုင်း	အမှန်အတိုင်း
အရယူပေခဲ့တဲ့	အရယူပေးခဲ့တဲ့
အရာ၇ှိ	အရာရှိ
အရေကျုံ ့ပြီ	အရေကျုံ့ပြီ
အရည်အတွက်	အရေအတွက်
အရေးအပေါ်	အရေးပေါ်
အေ၇းယူနိုင်ဖို့	အရေးယူနိုင်ဖို့
အရေးယူနိ်ုင်မယ့်	အရေးယူနိုင်မယ့်
ရေးသားပြောဆို	အရေးအသားအပြောအဆို
အရင်ကထပ်	အရင်ကထက်
အရင်တုံးက	အရင်တုန်းက
အရင်း	အရင်
အရင် းနှီးနည် းတယ်	အရင်းနှီးနည်းတယ်
အရင် းနှီး 	အရင်းနှီး 
အရင် းနှီး	အရင်းနှီး
အရင် းအနှီးလုပ် ခိုင် းမည်	အရင်းအနှီးလုပ် ခိုင်းမည်
အရင်းအနီး	အရင်းအနှီး
အရင် းအနှီး 	အရင်းအနှီး 
အရင် းအနှီး	အရင်းအနှီး
အရောင် းအဝယ် လုပ် ခြင် း	အရောင်းအဝယ် လုပ် ခြင်း
အရရစ်ကျ	အရစ်ကျ
အရေအသွေး	အရည်အသွေး
အရမ်းကျနေတပြီး	အရမ်းကျနေပြီး
အဇမ်း	အရမ်း
အရှုံးပေါ်နေစဲ	အရှုံးပေါ်နေဆဲ
အလကားပေသုံး	အလကားပေးသုံး
အလကားရနိူင်တာ	အလကားရနိုင်တာ
အလသာ	အလဟသာ
အလိုမရှိဖူး	အလိုမရှိဘူး
အလိုအလောက်	အလိုအလျောက်
အလင်ပြပေပါ	အလင်းပြပေးပါ
အလုပ်ကိ်ု 	အလုပ်ကို
အလုပ်လုပ်မဲ့	အလုပ်လက်မဲ့
အလုပ်သမာ	အလုပ်သမား
အလုပ်အကို	အလုပ်အကိုင်
အလုံုးစုံု	အလုံးစုံ
အလျှော်လိုချင်တာမျိုး	အလျော်လိုချင်တာမျိုး
အလောက်	အလျောက်
အလွှဲသုံးစာမှုနဲ့တော့	အလွဲသုံးစားမှုနဲ့တော့
အလွှဲသုံးစားလုပ်တယ်	အလွဲသုံးစားလုပ်တယ်
အလွန်ဘဲ	အလွန်ပဲ
အလွန်အကျွှံ	အလွန်အကျွံ
အလွှန်	အလွန်
အလှုရှင်	အလှူရှင်
 အလှမ် းမဝေးတဲ့ 	 အလှမ်း မဝေးတဲ့ 
အလှမ် းမဝေးပါစေနှင် ့	အလှမ်းမဝေးပါစေနှင့်
အလ ျှင်း	အလျှင်း
အဝတ်လျော်စက်	အဝတ်လျှော်စက်
အဝတ်လျော်ရင်	အဝတ်လျှော်ရင်
အသေရေဖျက်မှု	အသရေဖျက်မှု
အသေဘဲ့	အသေပဲ
အသအပျောက်	အသေအပျောက်
အသက်မပြည်သေးတဲ့	အသက်မပြည့်သေးတဲ့
အသက်ရှုကျပ်	အသက်ရှူကြပ်
အသက်ရှင်ဉီးမှာပါ	အသက်ရှင်ဦးမှာပါ
အသင်းပင်း	အသင်းပင်
အသင် းရှိသလို	အသင်းရှိသလို
အသင် းလဲ ရှိသည် 	အသင်းလဲ ရှိသည် 
အသင် းလဲ	အသင်းလဲ
အသင် းသား	အသင်းသား
အသင် း 	အသင်း 
အသင် း	အသင်း
အသင် း 	အသင်း
အသိ်ုင်းအဝိုင်း	အသိုင်းအဝိုင်း
အသုံးချလိုက် ခြင် း	အသုံးချလိုက် ခြင်း
အသွင်းအပြင်	အသွင်အပြင်
အာဟင့်	အဟင့်
အာဏာပိုငင်	အာဏာပိုင်
အာဏိသင်တွေ	အာနိသင်တွေ
အာမညောင်းသရွေ ့	အာမညောင်းသရွေ့
အာရုံစိုက်နိုင်တာ်	အာရုံစိုက်နိုင်တောင်
အာရုံမစိုက် သင် ့ပါ	အာရုံမစိုက် သင့်ပါ
အာရုံး	အာရုံ
အာရှနိ်ုင်ငံ	အာရှနိုင်ငံ
အားကစားဘတ်	အားကစားဘက်
အာကိုးမလဲ	အားကိုးမလဲ
အားနားချက်	အားနာချက်
အားပေးလှုန့်ဆော်တာမျိုး	အားပေးလှုံ့ဆော်တာမျိုး
အားပေး အားမြှောက်မှု့	အားပေး အားမြှောက်မှု
အားပေးအားမြောက်	အားပေးအားမြှောက်
အားလု့း	အားလုံး
အားနာချက်	အားသာချက်
ဇ။်	၏
ဇ။် 	၏
ဧ။်	၏
အီသီယိုးပီးယာား	အီသီယိုးပီးယား
ဥပတီရုပ်	ဥပတိရုပ်
ဥပေး	ဥပဒေ
ဥမမာ 	ဥပမာ 
ဉီးဆောင်	ဦးဆောင်
၁၀ဉီး	၁၀ဦး
ဉီးတင်မောင်ဆွေ	ဦးတင်မောင်ဆွေ
ဦးထွန်းနိူင်	ဦးထွန်းနိုင်
ဦးနောက်	ဦးနှောက်
ဦုးလေးကလဲ	ဦးလေးကလဲ
ဧပြီလမွး	ဧပြီလဖွား
အဲဒါမျိး	အဲဒါမျိုး
အဲဒီလိုနဲ 	အဲဒီလိုနဲ့
အဲဒီ	အဲဒီ
အဲဒီကာ	အဲဒီ့က
အဲဒီတုန်းက	အဲဒီ့တုန်းက
အဲဒီဘက်	အဲဒီ့ဘက်
အဒီဲမှာ	အဲဒီ့မှာ
အဲဒီမှာ	အဲဒီ့မှာ
အဲဒီအတွက်	အဲဒီ့အတွက်
အဲဒီ	အဲဒီ့
အဲ့ဒိ	အဲဒီ့
အဲကြောငံ	အဲ့ကြောင့်
အဲတာ	အဲ့တာ
အက်တုန်းက	အဲ့တုန်းက
အဲတာ	အဲ့ဒါ
အဲဒိ့နေ့	အဲ့ဒီနေ့
အဲဒိလိုနဲ့ 	အဲ့ဒီလိုနဲ့ 
အဲဒီလို	အဲ့ဒီလို
အဒီ	အဲ့ဒီ
အဲဒီ	အဲ့ဒီ
အဲ့မာ	အဲ့မှာ
အဲ့လိုဆိူရင်ကော	အဲ့လိုဆိုရင်ကော
အဲလိုဘဲ	အဲ့လိုပဲ
အဲလို	အဲ့လို
အ့	အဲ့
အဲ	အဲ့
အံသြော်	အံသြ
အံသြောစရာ	အံ့သြစရာ
အံ့သြောစရာ	အံ့သြစရာ
အံ့သြတုန်လုပ်	အံ့သြတုန်လှုပ်
အပ်အောတယ်	အံ့သြတယ်
အံ့သြဖွယ်ရာ	အံ့သြဖွယ်ရာ
အံ့အားသင် ့ စရာက 	အံ့အားသင့်စရာက 
အံ့ကြတာလဲ	အံ့ဩကြတာလဲ
အိုထှာအေ	အိုတာအေ
အိုရမဲ့လူ	အိုရမယ့်လူ
ဥက ္ကလာပ	ဥက္ကလာပ
အင်္က ျီ	အင်္ကျီ
အိင်္ကျီ 	အင်္ကျီ
အင်းဂါးလိပ် လိုတွေဘဲ 	အင်္ဂလိပ် လိုတွေပဲ 
အင်္ဂင်္လိပ်	အင်္ဂလိပ်
အပ်လိ်ု့ 	အင်္ဂလိပ်
အင်္ဂ ါ 	အင်္ဂါ
အင်တာနတ်ရှင်နောင်	အင်တာနက်ရှင်နယ်
အင်တာပျူ 	အင်တာဗျူး
အင်းအားဖြည့်	အင်အားဖြည့်
အောင်နိူင်စိုး	အောင်နိုင်စိုး
အောင်ပီးသား	အောင်ပြီးသား
အောင်ပွွဲဝင် 	အောင်ပွဲဝင်
အောင်မြင်မှု့	အောင်မြင်မှု
အိုင် ဒီယာကောင် းတွေရှိရင်	အိုင် ဒီယာကောင်းတွေရှိရင်
အိုင် ဒီယာကောင် း	အိုင် ဒီယာကောင်း
အိုင်အက်စ	အိုင်အက်စ်
အစ်က်ု	အစ်ကို
အစ္စလာ်မ်မစ်ဘာသာ	အစ္စလာမ်မစ်ဘာသာ
အစ္စလာမ်မ်စ	အစ္စလာမ်မ်
အစ်	အစ်မ
အိ်တ်ဖွင့်ပေးစာ	အိတ်ဖွင့်ပေးစာ
အိတ်	အိတ်စ်
အုပ်သား	အုတ်သား
အုပ်	အုတ်
ဓမန္တရာယ်	အန္တရာယ်
အန္တရယ်	အန္တရာယ်
အန္တ/ရာယ်	အန္တရာယ်
အန္တာရယ်	အန္တရာယ်
အန္တာရာယ်	အန္တရာယ်
အိမ်းခန်း	အိမ်ခန်း
အိမ်တအိမ်	အိမ်တစ်အိမ်
အိမ ်ထောင်သည် 	အိမ်ထောင်သည် 
အိ်မ်ထောင်	အိမ်ထောင်
အိမ်နီးချင်းနိ်ုင်ငံတွေ	အိမ်နီးချင်းနိုင်ငံတွေ
အိန်မီးချင်း	အိမ်နီးချင်း
အိ်မ်	အိမ်
အုးံ	အုံး
အွန်လိုင်းစံနစ်	အွန်လိုင်းစနစ်
အွန်လိ်ုင်း	အွန်လိုင်း
၄င်းတို	၄င်းတို့၏
